A|So, What kind of experience do you, do you have, then with child care?|qw	B|I guess, I think, uh, I wonder if that worked.|qy^d
B|How about you?|qo	A|Uh, no,|nn
A|What is the nature of your company's business?|qw	B|Well, it's actually, uh,|^h
B|Well, how to you handle that, the long range or medium range planning on finances?|qo	A|Well, actually we haven't had to. Uh, until just recently.|sd
A|But, uh, uh, I was just curious, what, uh, part of the country.|qw	B|Oh, Stockton.|sd
B|How about you?|qo	A|Uh, Cincinnati, actually.|sd
B|Well what other long range goals do you have besides college?|qo	A|Uh, well I think, either my wife or I would like to pursue advanced degrees at some point|sd
A|Well, How would you go about changing it?|qo	B|You know, that's a,|%
A|Uh, so, what do you think, uh, about putting the elderly in a nursing home?|qo	B|Well, I think that it, it varies on on the individual basis.|sv
B|What do you think?|qo	A|Yeah|b
B|What about you?|qo	A|Uh, I work for a fairly large company.|sd
B|Now, how long does it take for your contribution to vest?|qw	A|God, I don't know.|sd
A|Well, uh, could you give me an example of a case where you think that?|qo	B|Well, in a criminal case, say one in which, you know, there is, like, say assault or some such. I think there ought to be a unanimous, uh, vote because by law and by constitution there must be proven beyond a shadow of a reasonable doubt that the person in question did this.|sv
B|But what kind of things are you  looking for?|qo	A|Well, the  Saturns you can get air bags in them.|sd
A|What is your, uh, community, uh, currently doing with regard to recycling?|qw	B|Uh, basically, they're just, uh, having various recycling, uh, bins, uh, located for, uh, trash pickup.|sd
A|uh, what do you think was different ten years ago from now?|qo	B|Well, I would say as, far as social changes go, uh, I think families were more together.|sv
B|Uh, what  do you  think about that?|qo	A|We,|%
B|Well, how, how old are you?|qw	A|I'm twenty-eight.|sd
B|which group are you saying  is the one trying?|qw	A|I'm saying that  the, uh, the group that is just trying to survive from day to day, where both parents are working is more of the majority than the, than the people that have the higher standard of living.|sv
A|but if you had, if you had, uh, parents say or, or, or grandparents, whatever it is, uh, who were ready, who, who you thought might benefit from a nursing home, what do you think you would look for?|qw	B|Uh, well I, actually my dad's, my dad's almost ninety|sd
B|How old are your children?|qw	A|Uh, one's twenty-six|sd
A|So, who's your favorite team?|qw	B|My favorite team is the Pittsburgh Steelers.|sd
B|How about your favorite team?|qw	A|Huh.|%
B|Who's that?|qw	A|It's pretty much going between Washington. They are undefeated. And, uh, Buffalo, New Orleans, and Chicago because Chicago has only lost twice|sd
B|What do you think about, uh, Houston?|qo	A|Houston.|b^m
A|Who, who did they play?|qw	B|They played Dallas.|sd
B|Um, what cities are they looking at?|qw	A|Uh, right now I think this Memphis, they're, they're trying to get the  teams.|sd
A|Uh, what sorts of cases were they?|qw	B|They were just, you know, small time cases where, uh, trailers and banks were involved, you know.|sd
B|What do you do with your budget?|qw	A|What do I do,|t1
A|so uh,  what do|qw	B|We're trying,  we're trying to, uh,|sd
A|So, what do you and your husband do?|qw	B|We're missionaries actually.|sd
A|Overseas, where would you be going?|qw	B|Africa,|sd
A|How long would you be there?|qw	B|About four years.|sd
A|With, with what Church?|qw	B|Uh, we're with Wycliff Bible Translators.|sd
A|So, uh, what, what, uh, what languages do you speak besides English, of course?|qw	B|Well, I have a smattering of about ten different ones,|sd
B|How about you?|qo	A|Well, well right now, I, I'm just a student.|sd
A|What kind of, what kind of jobs have you done?|qw	B|Well, well, I do uh, research in computer science|sd
A|what's the old country music like?|qw	B|Oh, like, like Hank Williams.|sd
B|Well, how old are you?|qw	A|Twenty-eight.|sd
A|How old are you?|qw	B|Oh, I'm, uh, twenty-eight|sd
A|what kind of music is, does  what  songs does he play?|qw	B|It, it,|%
B|So how serious is the, subject of crime in your area?|qo	A|Well, needless to say, here in Washington, D C this is the war zone.|sv
A|And, uh, how about you|qo	B|Well, I think that in some cases, it is warranted.|sv
A|how do you feel about it?|qo	B|Well, they do have, uh, a major internal problem|sv
A|What's your synopsis?|qo	B|Well, I do, I do realize that, uh, uh, the Bush Administration isn't too happy with, with how they're handling their internal, uh, strife, you know, as far as diplomacy is concerned|sd
B|So, what what is the E P A recommending now?|qw	A|Oh, they really didn't propose any solutions.|sd
B|but what  what  about emissions?|qw	A|Yeah.|b
A|What is your name by the way?|qw	B|Uh, I'm Ann.|sd
B|So what's the prevailing thought within the community?|qw	A|Um,|%
B|but what about the community?|qw	A|They, well,|%
A|How's he handling that?|qw	B|Uh, he'd much rather be living alone in his apartment down in Florida.|sd
A|and how do you feel about them?|qo	B|Uh, pretty good, actually.|sd
A|What kind of a degree have you got?|qw	B|I've got a Bachelor's in electrical engineering|sd
A|How long have you been with them?|qw	B|I've been with them for seven years.|sd
B|what about you?|qo	A|Well, I, uh, work in Washington at the Naval Research Laboratory.|sd
A|or, or, or what do you think?|qo	B|Well, that's, that's a really hard question.|^h
B|how do you think that, uh, the viewpoints differ?|qo	A|I think a lot of it is just, uh, the fact that in the U S you're so far removed, uh, in a lot of cases from, say, conflicts|sv
B|I mean what if you don't even realize that you're subject to paying, uh, income tax on something that you purchase mail order?|qw	A|Really, I, I, I don't think that's a valid argument.|sv
A|what do you usually do as far as budgeting?|qo	B|We have a very detailed budget. Because my husband is a finance major.|sd
A|or  or how do you work that?|qo	B|Yes.|ny
B|Now where does the source light go?|qw	A|Like across the street.|sd
B|What about yourself?|qo	A|Huh.|b
A|What are your, uh, what sorts of things would you consider important?|qw	B|Well those and probably the security aspect of it.|sd
A|What type of field of work are you in?|qw	B|I'm in the oil business.|sd
B|so what else do you think is important?|qo	A|Well the, uh,|%
B|What about, what about you?|qo	A|Well, I read, uh,|sd
A|I mean what do you, what, what do you find interesting versus what do you find boring?|qw	B|Well right now trying to keep abreast of, uh, what's going on in Europe, you know, with all the, U S S R's satellites breaking off, trying to become independent and, you know, European community coming together.|sd
A|So, what kind of music you into?|qw	B|Well, I have a, uh, pretty wide taste, uh, in music, ranging from progressive rock to jazz to, uh, lot of different forms of, uh, music.|sd
A|What kind of progressive stuff?|qw	B|Uh, lot of stuff that actually has, uh, ended up becoming popular like, uh, Nirvana and, uh, oh, you know,|sd
A|What's the standard?|qo	B|Uh,|%
A|What do you think you'll, uh, what kind of a car do you think you'll buy next?|qw	B|Well since I just turned forty, I'm thinking about a forty year old man's car, something, uh, something real sporty|sd
B|How about you?|qo	A|Well, I think the next car we get will probably be a well|sd
A|What kind of, what make is the mini van?|qw	B|It's a Mazda.|sd
A|What kind of crime do you think, uh, is the most prevalent in our society?|qw	B|Oh, boy, probably, uh, robberies, people stealing from each other.|sv
A|What, what do you think is, uh, is an appropriate, uh, punishment for some of the various, you know, such as, things such as rape or, or, uh, murder or something like that.|qw	B|Well for, for a lot of the kind of premeditated murders, I think the death penalty is,|sv
B|So, uh, well how long have you been married?|qw	A|Uh, about five years.|sd
B|How about you?|qo	A|Well, I, I just live in a, I live in an apartment now.|sd
A|and the windows have you, what type of windows are you putting in?|qw	B|Huh.|%
B|Oh, what kind of drugs did you use,  if you don't mind?|qw	A|Uh, marijuana, cocaine  and amphetamines.|sd
A|What's that?|qw	B|It's, uh, it's a new, uh, form I think,|sv
A|What school you going to?|qw	B|I'm at East Carolina.|sd
A|Well, what are you studying?|qw	B|Oh, I'm an interior design major,|sd
A|Where do you take your cans?|qw	B|Well, as you say, it takes a while to build it up.|^h
A|Oh, what are their names?|qw	B|Tibby and Liberty.|sd
A|Which is the dog and which is the cat?|qw	B|Tibby is the dog|sd
B|Well, now, so if you were going to have a dinner party, what would you make?|qw	A|Um, let's see,|^h
B|So if you have a, a dinner party and you're going to serve, uh, seafood for supper, what type of, uh, hors d'oeuvres would you serve prior to the meal?|qw	A|Uh,|%
B|And then when you serve the meal, what type of wine would you have with, uh, with the, with seafood?|qw	A|Oh, all these hard questions|^h
B|So you graduated from which high school?|qw	A|Trinity.|sd
A|what about Hawaiian luau.|qw	B|Oh, that would be good.|sv
B|How old is it?|qw	A|It's about six months.|sd
A|what's the best method?|qw	B|I don't know.|h
A|How old is it?|qw	B|She'll be sixteen in May.|sd
A|How long did it take?|qw	B|I think it was like a six week program.|sd
A|and so what do you think, next to salary do you rank, is the most important job benefits?|qw	B|Uh, I would say the medical, uh, group insurance area as far as, uh, covering medical costs for yourself or family members.|sv
B|How about yourself?|qo	A|Uh, well I'm,|%
B|What do you do there?|qw	A|Well, um, I'm not actually on the teaching faculty,|sd
A|What kind of, what kind of work do you do?|qw	B|Uh, I'm doing basically system, system design work and, uh, implementation work for the speech, for the speech group uh, here.|sd
A|What about you?|qo	B|Well, um, I'm research stuff here now|sd
B|so, So, what kind of music do you like?|qw	A|Oh, okay.|bk
A|what about, uh, classic rock type stations.|qw	B|Uh, I don't listen to the radio at all.|sd
B|Why is that?|qw	A|Huh?|br
B|Why is that?|qw	A|Why|%
B|Where are you from Tina?|qw	A|Um, I'm from Maryland|sd
A|Uh, what kind of things do you do?|qw	B|Well, um, we do a lot of things with them, you know,|sd
B|What do you do during those, those days?|qw	A|Um, we spend a lot of time at the playground|sd
B|what do, what do you do?|qw	A|I'm a nurse.|sd
A|Are you, where are you from?|qw	B|Um, uh, I'm in Dallas, Texas.|sd
B|what's your husband do?|qw	A|Uh, he, he works for Coca Cola.|sd
B|Which is your favorite?|qw	A|Oh, well, I couldn't live without the family vacations,|sd
A|How about yourself?|qo	B|Well, uh, we, we, as you do, take family vacations, uh, sometimes one a year,|sd
A|And where have you been on these cruises?|qw	B|Uh, Nassau, San Juan, Saint Thomas.|sd
A|Where are you from originally?|qw	B|We're from Illinois originally.|sd
A|What's the best part, from your point of view?|qw	B|I like seeing other countries and shopping in other places.|sd
A|Huh. How long are the cruises?|qw	B|Uh, we've only gone on the seven day cruises.|sd
B|What have you seen lately?|qw	A|Well, uh, it's funny, when I tried, to make the call the other days,|^h
A|What about the speed?|qw	B|If you get,  if you get down on the ground you really can.|sv
A|How was your care at Parkland?|qo	B|Uh, because it was a life threatening situation, it was very good.|sv
B|so now what are your opinions on recycling?|qo	A|Well, I definitely think that we need to start recycling.|sv
A|so, what are, what are your views on capital punishment?|qo	B|I have ambivalent feelings because I don't think it serves as a kind of deterrent we would like to think it is.|sd
B|What, what kind of work do you do?|qw	A|Uh, I'm a research engineer,|sd
B|What kind of crimes would you use it for?|qw	A|Uh, premeditated murder. Crimes of that nature, I think should definitely,|sv
A|Um, what's our topic?|qw	B|Taxes.|sd
A|What do you do?|qw	B|Um,|%
B|What are you studying down there?|qw	A|Physics.|sd
B|What|qw	A|And, uh  you know, and so the students were, you know, to some extent, motivated to learn.|sv
A|What do you do?|qw	B|About the same thing.|sd
A|Uh, what would you do to change it? To make it better?|qw	B|Well, uh, the, the only I can, I you know,|%
A|Where do you get most of your news?|qw	B|I watch the MACNEIL LEHRER news hour,|sd
A|Where, where are you?|qw	B|I'm in Dallas.|sd
A|What area do you live in?|qw	B|I live in Houston.|sd
A|Let's see what else do you do to your house?|qo	B|Well, I've done some rewiring on it.|sd
A|Which ones?|qw	B|I tape THIRTY SOMETHING, and L A LAW.|sd
B|And what night is it on?|qw	A|Well, we watched it,|^h
B|What brand are they?|qw	A|One of them's a Compaq|sd
B|What kind of consulting do you do?|qw	A|Um, well, I actually do some work, working at M I T and at NIST, National Institute of Standards and Technology in Washington,|sd
B|What kind of work do you do when you're consulting?|qw	A|Um, well, it depends,|^h
B|Where, Where are you,|qw	A|I haven't ever noticed the thirty second warning actually.|sd
B|What time is it now where you are?|qw	A|Uh, about twenty after four.|sd
A|And what do you work on at T I?|qw	B|I'm a computer programmer on the I B M main frames.|sd
A|Um, what do you think about the proposal that all young Americans should spend a year or two,|qo	B|I think it's a good idea.|sv
A|What part of the country?|qw	B|Well, I live in Richardson right now.  Which is just,|sd
A|How  about you?|qo	B|Well, I have, uh, a nine year old and a six year old|sd
B|What kind of music do you like?|qw	A|I, um, I was thinking about it for a long time,|^h
A|And where are you from?|qw	B|Pennsylvania.|sd
B|What are your favorite television shows?|qw	A|Well, I don't really watch too many T V shows other than, uh, occasionally I'll, I'll turn on DONAHUE because it comes on in the morning when I seem to be getting ready around here.|sd
A|Is that on, what what station?|qw	B|Uh, I don't even know, to tell you the truth|sd
A|What other shows do you like?|qw	B|Uh, I prefer OPRAH WINFREY to DONAHUE|sd
A|So do you know of any other shows in the even, or something that you enjoy?|qo	B|Oh, uh, tonight I'm looking forward to seeing GOLDEN GIRLS.|sd
A|So what have you seen interesting on OPRAH WINFREY lately?|qw	B|Lately, I haven't been catching it because of my work schedule.|sd
A|What have you seen recently that you enjoyed?|qw	B|Uh, I don't know, um,|^h
A|So, well what business are you in?|qw	B|I'm, I'm an electrical engineer.|sd
A|Well, what movies are you looking forward to seeing now?|qw	B|Um, well, I'm, I'm only twenty-seven years old|^h
A|So what do you know about it.|qw	B|Well, actually I'm, I, I'm quite versed lately.|sd
B|And, uh, what about you?|qo	A|Well, I guess I'm not too aware of how much they're spending right now You know.|sd
B|what do you think about that? It really is.|qo	A|Well, yeah,|^h
A|or where are you at?|qw	B|Arlington.|sd
A|What about politics on it?|qo	B|Oh.|b
A|And what kind do you have?|qw	B|I've got a male Siamese about a year old here.|sd
B|How about you?|qo	A|Well, we have a cat, um,|sd
A|Oh. Uh, how's the disposition of your Siamese cat?|qw	B|Well, it's, uh, you know they're just, uh, aggressive by nature|sv
B|How about yours?|qo	A|Well, yeah,|fo_o_fw_"_by_bc
A|So how do you get most of your current event information?|qw	B|Well, , see I'm going to school right now,|sd
A|What kind of pets do you have?|qw	B|Oh, we have one rotten cat.|sd
A|How does he treat the other people?|qw	B|Just, uh, stays away or runs usually.|sd
B|What are they doing up there?|qw	A|Well, here in Saskatoon, uh, much the same thing.|sd
A|Jimmy , so how do you get most of your news?|qw	B|Well, I kind of, uh, I watch the, uh, national news every day, for one.|sd
A|What, what, uh, newspapers do you read?|qw	B|Well, I read, uh, the local newspaper|sd
B|What about Mustang G T|qo	A|Mustang G T|b^m
B|what kind of track is that?|qw	A|Uh, just like a, uh, set up a lot of times|sd
A|Uh, what are you thinking about buying?|qw	B|Uh, I think I'd like to get, uh, B M W or if I go the German route, which I'm kind of leaning towards right now, but, uh, or maybe a, I mean, a, a Acura Legend. Uh|sd
A|How many kids do you have?|qw	B|I think I think we're going to talk about parents spending time with their children.|sd
B|So what do you think about, uh, recycling programs in Atlanta, Julie?|qo	A|The recycling program here is just terrible.|sd
B|Who are you?|qw	A|Oh, by the way, may name's Julie.|sd
B|what kind of plastic stuff can you recycle, do you know?|qw	A|The only thing I know that you can recycle is milk jugs.|sd
B|What about like those grocery bags?|qw	A|Oh, yeah,|b
B|How can it be bad?|qw	A|It is, because they,|sd
B|Well, what about, uh, papyrus, you know, made out of you know, bamboo stuff, from the from the  banks of  the Nile.|qo	A|I'm sure that's fine.|sd
B|What do you think?|qo	A|I mean, everybody, everybody everybody has a computer.|sv
A|Uh, what, what station do you listen to?|qw	B|Uh, it's a local radio station.|sd
A|So, how did that happen, anyway?|qw	B|Uh, financial trouble.|sd
A|I mean, when did it, when did they ,|qw	B|Oh, when did it happen?|br
B|So, how do you keep up?|qw	A|Oh, me, I, uh, good grief, I read the TIMES, LOS ANGELES TIMES.|sd
A|what did, how, how did you get to know about the T I thing?|qw	B|Oh, one of my instructors, uh, said that they were doing something like this|sd
A|what are you working on|qw	B|A, a Masters in, uh, information systems.|sd
B|Where at?|qw	A|At North Carolina State University.|sd
B|How do you like it out there|qw	A|Uh, I don't. Because, uh, I come from a lot, a bigger city than this one|sd
A|Where you at?|qw	B|Uh, well, I'm in Monterey, California right now|sd
A|When do you get out?|qw	B|Oh, probably be another twelve years.|sd
A|But, uh, but what if  they pay for it?|qo	B|Excuse me?|br
A|What if they pay for?|qo	B|If they pay for a P H D?|qy
A|What are some of your things you like to do?|qw	B|Well, when I have time I do like to sew,|sd
A|How old are they?|qw	B|Well they range from, let's see about a year and a half to nine years old.|sd
A|what did he shoot him with.|qw	B|Uh, well, uh, from what we can tell it was a pellet gun|sd
A|What are your cats' names.|qw	B|Uh, we have, uh, Bonzo, Bear, Poindexter, and Felix.|sd
B|And what do you have.|qw	A|I have Xanadu and Precious, and Rascal.|sd
B|What will you,|qw	A|I'm, I'm, I'm a photographer now.|sd
B|Huh. What's that about?|qw	A|A, uh, special effects man who somehow gets involved in this, um,|sd
B|How about yourself.|qo	A|Well, um, that's a hard question to answer because I do physical things, but I don't always set out for them to be exercise.|sd
A|what do you think is the biggest problem?|qw	B|The biggest problem, well, like in this part of town seems to be the attitude and the atmosphere in the schools that, uh, you know, you can throw money at it,|sd
B|what's that mean?|qw	A|That sounds like not as recent social changes, too, like back to the sixties or fifties, I guess|sd
B|What did you think about that idea?|qw	A|Well, I, I kind of, I thought, well, that, that might be possible since there are a lot of men in control of that kind of thing.|sd
B|So where are your, what are the places, you know, memorable places you've eaten?|qw	A|Uh, oh you okay you name it.|sd
A|why, which one were you going to recommend?|qw	B|Well, I mean, there's so many places here, you know,|sd
B|Where is that?|qw	A|Uh, Mount Vernon.|sd
A|Where did you all move from?|qw	B|Colorado Springs.|sd
A|How are you liking it?|qw	B|Oh, we love it up there|sd
A|Well, what are your hobbies?|qw	B|Well, actually my hobbies now are T shirt making.|sd
A|What kinds of, uh, sweat shirts and T shirts do you make?|qw	B|Um, right now I'm making Christmas ones with poinsettias and bears and all that kind of thing.|sd
A|Well, how's it going?|qo	B|Pretty good.|sd
B|Well, what are your hobbies?|qw	A|Well, I, I kind of have hobby fads, I guess.|sd
B|Well, how'd you learn to do that to fix them up?|qw	A|Oh, you just,|sd
B|Where'd you get the car?|qw	A|Well, we lived, we lived in South Dakota,|sd
A|How many music boxes do you have?|qw	B|Probably uh, about twenty.|sd
A|What's the most expensive one you bought?|qw	B|The most expensive.|b^m
A|Well how was Europe?|qo	B|economy.|sd
A|what does he think of your, uh, T shirts and,|qw	B|Well, he likes it all right.|sd
A|What kind of car would you like to buy next?|qw	B|Well, I guess Cadillac.|sd
A|Well, why would that be?|qw	B|Oh, I guess it's a General Motors product,|sd
A|If you had, uh, no financial requirements, if you could buy any car in the entire world, no matter what it cost, what would you buy?|qw	B|Oh, um, I think I'd still go with the Cadillac.|sd
A|Which type of Cadillac, uh, is your favorite?|qw	B|Oh, I don't know.|sd
A|What kind of, uh, General Motors cars have you had in the past?|qw	B|Mostly Oldsmobiles.|sd
A|What are dialing services?|qw	B|Where they, uh, intend to sell you things.|sd
A|How did Radio Shack work?|qw	B|If you go in and buy  anything they want your phone number.|sd
B|so, uh, well, uh, what kind of vacations do you like?|qw	A|Well, uh, I haven't been to many places,|sd
A|Where is that?|qw	B|It's, uh, well, it's in the Caribbean|sd
A|So, what did you do when you were in Europe?|qw	B|Uh, well, see, I went there when I was in high school, actually|sd
A|What did you do on the farm?|qw	B|Uh, uh, uh, well, not that much|sd
B|Uh, so, uh, where in France are you,|qw	A|Paris.|sd
B|And, uh, um, how long do you plan to be going for?|qw	A|Uh, two weeks.|sd
B|And, uh, what else are you planning to do, if anything?|qw	A|Museums, you know,|sd
B|Where have you gone first?|qw	A|Oh, where have I gone that's anywhere.|qh
B|what kind of things do you think can be done in, in, uh, in the long term?|qw	A|Well, can be done or will be done are two different things.|sv
B|what  kind of  foods would you have?|qw	A|Okay.|b
B|How long do you have to bake it?|qw	A|Um, let's see.|^h
B|How long would it be how long would it be in the microwave?|qw	A|Or maybe it's only half hour.|sd
B|Who won the game?|qw	A|They won in a squeaker.|sd
B|Who won that Portland game?|qw	A|You know, I wasn't, I, I I watched only a few minutes of it|sd
B|So what do you do?|qo	A|Well, that's basically what we do.|sd
B|Well first of all I, I have to ask you how, how old you are?|qw	A|Oh, I am twenty-seven.|sd
A|What type of exercise do you do?|qw	B|Well, I do, uh, jazzercise which is an aerobic, uh, program that,|sd
B|Well, what do you do?|qw	A|Uh, I really don't have a routine.|sd
A|What about, uh, white collar crimes like, uh, theft of trade secrets.|qo	B|I think those ought to be punished a whole lot worse than they are.|sv
A|Like what?|qw	B|Well, uh, say, embezzlement, right.|sd
A|What do you think?|qo	B|Uh, I, I don't think so.|sv
B|In what, uh, section of the government  do you work?|qw	A|I'm with  the F B I.|sd
A|Well what other, what, uh, what unique things you think, uh, that you can do about it in, in what, in Los Alamos?|qw	B|Well, uh,|%
A|club,  what club are you with?|qw	B|I'm sorry?|br
A|What club were you with?|qw	B|It's called, oh, what was it called City Sports, downtown Washington.|sd
B|Well, what newspapers, uh, do you read in Dallas?|qw	A|Uh, we have the DALLAS TIMES HERALD and the DALLAS MORNING NEWS,|sd
B|How come?|qw	A|Uh-huh.|fo_o_fw_"_by_bc
B|I mean who would steal a newspaper?|qw	A|You would be surprised.|sd
A|What part of California are you from?|qw	B|Uh, from Los Angeles,|sd
B|Wonder about them in what way?|qw	A|Well, uh, from what I understand there's been studies that, uh, these children are, uh, more rebellious.|sd
A|What do you mean?|qw	B|Uh, deliberate childbirth by surrogate mother.|sd
B|What, what do you envision for the next twenty years as far as women in American society?|qw	A|Uh, I think, I really don't have a vision|sd
A|What'd you do with them?|qw	B|Put them back|sd
B|What about you, you a,|qo	A|Well, most of my fishing is done at, um, area lakes around here, freshwater lakes|sd
A|How do you feel about credit cards?|qo	B|Personally, I do not care for them. Uh, although I find them a necessity in business and so forth,|sd
B|Well, from where are you calling?|qw	A|Oh, from the Dallas area.|sd
A|Well, what would you have at a dinner party?|qw	B|Well, uh, lately, since I have children I've cut down on having dinner parties|sd
A|Well um how long do you cook the meatballs|qw	B|The meatballs you just um after you form them fry them in a pan until they're uh browned on all all sides|ad
A|so which, uh, what basketball teams are you interested in?|qw	B|Well, I guess I'm a big Laker, L A Laker fan, when it comes to pros.|sd
B|How about you?|qo	A|Well, I'm, uh, originally from the Saint Louis area,|sd
B|where does Detroit fit in?|qw	A|Detroit's in that same, uh, that, that same, uh, division.|sd
B|now when you baby-sit, what age group children do you sit with?|qw	A|Well, gosh|ba
B|How much time did she spend with them?|qw	A|Not much at all|sd
B|And what are you studying?|qw	A|Uh, communications.|sd
B|uh, what base of communications would you be most interested in getting in to?|qw	A|Well, I'm majoring in, uh, public relations.|sd
A|What grade?|qw	B|oh, I started out with college and then went to high school|sd
A|What did you teach?|qw	B|I taught physical education.|sd
B|Uh, who wants to start this one?|qw	A|I don't know,|no
A|what do you think about it?|qo	B|Well, uh, the roles have definitely changed in the last generation or so.|sv
B|What's it like down there?|qw	A|Well, right now we're we're having the little bit of Spring that we have.|sd
A|Well, what movies have you seen recently, Valerie?|qw	B|Let's see,|^h
B|How was that?|qw	A|That was excellent.|sd
B|How long did that movie run?|qw	A|Uh, it's still on, to the best of my knowledge.|sd
B|Harrison Ford and, how does the story line go?|qw	A|It's, uh, he is a prosecuting attorney|sd
A|How big is the family you cook for?|qw	B|Uh, five.|sd
A|What,   what  does it have in it?|qw	B|It's|%
A|So but, uh, anyway, where do you like to eat?|qw	B|Uh, well, uh, we don't have any children|sd
A|Oh, which one do you like?|qw	B|Momo's.|sd
B|How do you usually find a, a new restaurant?|qw	A|Uh, well my husband's kind of the he, he's the ethnic fan.|sd
B|What's your favorite restaurant?|qw	A|Gosh, I guess just in Plano, I, Plano I like to go to Souper Salads.|sd
A|well how do you dress for work?|qw	B|My, my dress for work, uh, most of the time is, uh, rather comfortable and casual uh, usually, uh, slacks and a soft colored shirt.|sd
B|what kind, what kind of shoes do they wear down there?|qw	A|Well, we wear,|sd
A|What kind of cat is it?|qw	B|Just,|%
A|What was the other thing?|qw	B|Backpacking.|sd
A|Uh, what, what are some of the shows that you have been able to rent though?|qw	B|Uh, let's see.|^h
B|What have you seen recently?|qw	A|Well, maybe you, uh, you have seen DANCES WITH WOLVES.|qy^d
A|What did you think of that one?|qo	B|Enjoyed that quite a bit.|sd
B|What, now what night is that on now?|qw	A|Oh, that's Wednesday at, uh, seven thirty.|sd
A|how do you use them?|qw	B|Well, I do use them.|sd
A|Where do you work?|qw	B|Uh, do you know where Oakland and Hatcher are?|qy
A|How, how old are you?|qw	B|I'm, uh, thirty-three.|sd
B|And how do you feel about putting someone in the nursing home?|qo	A|Well, I don't think that uh, any of my relatives would really like to go there.|sd
A|What, what do you call Alzheimer disease and  stuff like that|qw	B|Yes,|b
A|So Frank, what, uh, type of, uh, budget do you or your family have?|qw	B|Well, uh I don't know that we really have a budget.|sd
B|Uh, about yourself?|qo	A|Well, I have to say I really don't have a budget.|sd
A|How big is your family?|qw	B|Uh, well we're, we have one on the way.|sd
B|How about yourself?|qo	A|I have two kids.|sd
A|What's your, uh, feeling?|qo	B|Uh, well I guess I, I guess I'm probably a little more to, toward the other direction.|sd
A|What sort of benefits would you like to get from a big company.|qw	B|Well, since I'm kind of on the, the older side, you know, I, I, I just feel like, uh, when I start talking about benefits, I talk about, I'm concerned about medical benefits|sd
A|Uh, what, what's your budget situation?|qw	B|Well, actually, uh, I've, I've had a couple of different situations.|sd
A|How has it been this week for you?|qw	B|Weather-wise, or otherwise?|qy
A|Oh, where did you go to school in Indiana?|qw	B|Purdue.|sd
A|uh, what do you think you would offer as far as, uh, information about selecting a school?|qw	B|Well, first I think they've got to have a pretty good idea of what they want to, what they want to do.|sv
A|What was your degree in?|qw	B|Uh, political science.|sd
B|Where are you at?|qw	A|Uh, U T D.|sd
B|What branch were you in?|qw	A|Huh?|br
B|What branch were you in?|qw	A|I was in the Air Force?|sd
A|what, what was your job?|qw	B|Uh, command post.|sd
B|What kind of a car do you drive now?|qw	A|I drive a Honda Prelude.|sd
B|What did you have before you bought that.|qw	A|I had a Buick Regal.|sd
A|Anyway, what are your, what are your first comments on that pauses and subject?|qw	B|Uh, my first comments on the budget.|b^m
B|What would you do?|qw	A|Well, as as far as the, you know, the deficit, that's a whole nother, uh, my perception of the budget, you know, the government.|sd
B|what kind of puppy you got?|qw	A|Well, uh, I think she's mostly German Shepherd.|sd
B|How long has it been since the first one?|qw	A|Uh, see, he, it, it was just over a year.|sd
A|What, what kind of testing do they do when you went?|qw	B|Uh, it's a urine test.|sd
B|And where did you go?|qw	A|I went to a small liberal arts college in Virginia.|sd
A|and, uh, what about you?|qo	B|I went to the University of Minnesota.|sd
B|Where do you live now?|qw	A|Uh, I live in Texas now.|sd
A|Where are you?|qw	B|Well, I'm in Texas.|sd
A|Um, what about you?|qo	B|Well, we do some dining out.|sd
A|Um, where, about is that?|qw	B|Um, well actually there's the Atlantic Cafe and Cafe Pacific,  and, uh,|sd
A|Now where is  the Atlantic Cafe?|qw	B|Atlantic Cafe is down on, I believe it's on McKinney.|sd
A|What did they name him?|qw	B|I can't,|sd
A|Where is your favorite place to go?|qw	B|Well, we haven't traveled outside the United States that much.|sd
A|What kind of painting was it?|qw	B|two little deals,|sd
A|Oh, well, what kind of paint did you use for the, um, bookends?|qw	B|Well, it's, uh, it, that's half the problem right there is that it wasn't, it was a oil base,|sd
A|Well, how long did it take you all?|qw	B|Well, a couple of week ends|sd
A|Well, how did you like that topic?|qo	B|Uh, I don't know,|sd
A|How old a group, how old are the children go with this center where you work?|qw	B|Um, in my room they go from eight weeks to nine months.|sd
A|And, uh, seeing as you've got some older children, I, I'm wondering, how did you handle that, when they were growing up?|qw	B|Yeah.|b
A|Well what kind of car, uh, are you thinking of buying next?|qw	B|Uh, more than likely, it's going to be a Chrysler.|sd
A|What year is it?|qw	B|It's a eighty-eight.|sd
A|And why don't you like the Mustang?|qw	B|It's, um,|%
A|Well, what, uh, what things do you consider when you buy a car?|qw	B|Um, the gas mileage for one thing,|sd
B|what do you feel are some of the main problems?|qw	A|Well, I'm in a, I'm in an urban area.|sd
B|what, what do you do, now?|qw	A|Well, we have saved our newspapers for years and years because the, uh, Boy Scouts our boys have been involved in have, uh, had a huge recycling bin, over at Resurrection Lutheran Church|sd
B|well, tell me what kind of books have you read?|qw	A|Well, to tell you the truth, I've been going to college for the last four years|sd
A|What are your thinkings on what they can do, what they'll be able to do?|qo	B|Well, I think that, uh, you know, with, uh, so much controversy over Ruben Sierra not signing and asking us for so much money, it's, um, you know, I think|sv
A|Well, what  do you think of Howse, who is the coach for the pitchers?|qo	B|The pitching coach?|br
A|How about you?|qo	B|Um, actually I, I'm pretty untalented|sd
B|or how did you make a quilt?|qw	A|Um.|%
A|So how do you just figure ,|qw	B|Well, you know, it depends upon our weather here. You know,|sd
B|So how do you dress?|qw	A|Well, um, I'm going to talk about when I was working as a teacher and when I  was working at now.|oo_co_cc
B|Where did you live before?|qw	A|Um, we lived in Utah before|sd
A|Well, uh, what is your favorite kind of music?|qw	B|Well, I have to say my favorite type of music would probably be, uh, classical music.|sd
B|or what era do you, era do you like the most?|qw	A|Oh, well, I guess I like a wide range. Uh, everything from, uh, from Baroque through at least some modern music.|sd
B|What is that?|qw	A|Well, they, they give an, uh, an English translation on a, on a screen up above the stage.|sd
A|How, how old are they?|qw	B|One is thirteen and one is eleven.|sd
A|How do you feel about the Viet Nam war?|qo	B|Huh, well, um, you know, I guess it's pretty deep feelings, uh,|sd
B|now. Well, Mark, um, what was that again?|qw	A|Um, do you think, I mean, do you think, our the investment in lives and money was worth it?|qy
A|What, what effects do you think it's had on our country?|qw	B|Downside. Um, uh, well,|bf
A|So, uh, Mike, what are your opinions on, uh, trial by jury?|qo	B|Well I work for an insurance company|^h
A|or how does that work?|qw	B|Well, I was just talking about any company.|sd
A|Why?|qo	B|And  I went  to college for four years and got out, you know,|sd
A|Why is that?|qo	B|so. But, uh, you know, for some people that's good.|sv
A|Where you going to school?|qw	B|At Georgia Tech.|sd
A|who do you work for?|qw	B|I, I don't work.|sd
B|Oh, what's that about?|qw	A|That was about a, the Interior Minister,|sd
A|What kind of work do you do?|qw	B|I'm a Payroll Clerk.|sd
A|Uh, Robert what do you, uh, think, what substances do you think are the most, uh, likely causes of air pollution?|qw	B|Um, gee,|ba
A|Uh, what do you think individuals could do, or society could do to alleviate this problem.|qw	B|Uh, I don't, uh, I don't know whether we could do a whole lot as individuals. Uh, maybe just take good care of our cars, and make sure we keep our pollution devices clean and all that sort of thing. Um,|sv
B|What do you think we can do?|qw	A|Uh-huh,|b
B|And what is, what is he?|qw	A|He's like a semigovernment type agent. Who goes out then to, uh, works for the Phoenix Foundation, supposedly.|sd
A|Let's see, how about, uh, MAN FROM UNCLE?|qo	B|I do seem to|%
A|Where  are you from?|qw	B|I'm in Raleigh, North Carolina.|sd
B|Oh how does he do serious.|qo	A|He's good,|sv
A|Well what have you seen?|qw	B|I think the last movie that we went out to see was DANCES WITH WOLVES.|sd
A|So what do you, what do you consider your favorite shows?|qw	B|Um, I think my favorite show is HUNTER.|sd
A|What, what part of the country are you from?|qw	B|I'm living here in Texas.|sd
A|Well, how do you, how do you feel about, uh, companies drug testing prior to hiring?|qo	B|Oh, uh, I was tested, uh, within my company.|sd
B|How'd, how did they, how do they pick their people?|qw	A|Uh, well, I think all college players have to do an initial drug test at a certain point prior to the season|sd
A|What type of job do you have?|qw	B|Well, I'm an environmental engineer|sd
A|so what kind of car are you thinking about getting?|qw	B|Well, none at the moment|sd
A|So, uh, what do you think about it?|qo	B|Well, um, I guess I, I'm more concerned about public safety than I am about the, um, the concern for the private, uh, the idea of, preserving privacy for, the individual, um,|sd
A|What limits ought to be put on it, do you think?|qw	B|Well, the limits, uh, uh, would, I think, have to do with what I'd alluded to before, that there needs to be a further, um, that, that one positive on a drug test, would not constitute, uh, dismissal or grounds for whatever the company or agency might, uh, have set up for those who genuinely have a problem.|sv
A|What processor does it have in it?|qw	B|Um, I don't know,|no
A|Oh what kind of work do you do on it?|qw	B|Um, I do, um, television ratings|sd
A|Your husband, what, what group is your husband in?|qw	B|Um, something with the defense.|sd
A|Well, how many different types of packages do you use?|qw	B|At home?|qy^d
B|so  Where did you get your recipe for it?|qw	A|Um, I guess mostly out of an international cookbook that I have.|sd
A|What do you serve with it?|qw	B|Huh?|br
A|What do you serve with it?|qw	B|I like to serve, um, a wild rice with it.|sd
B|Oh, what?|qw	A|Uh, do you like angel food cake?|qy
B|where did you get,|qw	A|And you can put some  cucumber slices on too.|sd
B|where did you get this cook book?|qw	A|I got it at the Checkbook Store.|sd
A|what was that?|qw	B|It's, uh, it's a baked bean recipe.|sd
B|or what was the whole deal on that?|qw	A|Uh, they still have some, some, uh, some draft picks, uh,  that they got,|sd
B|What kind of questions did you ask about the private sitter before you took her over there?|qw	A|Um, gosh|^h
B|So, what made you decide to put her in a Montessori school?|qw	A|Well, I checked a lot of places out, you know, the Kinder Cares and the,  stuff  like that.|sd
B|In building, which building?|qw	A|Well, are you Summit or are you, uh,  Spring Creek?|qy
A|What building are you in?|qw	B|I'm building, uh, one.|sd
B|So how's the how's the weather in building two?|qo	A|The weather in building two is cold|sd
A|From?|qw	B|From California.|sd
A|So what do you think of the Texas weather?|qw	B|Not as nice as California|sd
A|How long have you been here?|qw	B|Oh, five years now.|sd
A|Where are you from in California?|qw	B|Southern California.|sd
B|Well, how,  like how much is an Oriole game?|qw	A|Oriole game?|^h
B|And what do they say about finding adequate child care?|qw	A|They,|%
B|what kind?|qw	A|An English setter, you know,|sd
A|what are the what are the symptoms?|qw	B|Uh, he, he's got a bad back|sd
B|How did you get into this.|qo	A|Well, my best friend in Virginia's daughter, is a part of this project in Texas.|sd
B|to where do they get it?|qw	A|Well, I don't know,|sd
B|Where, where do you usually go?|qw	A|Oh, well, let's see,|^h
B|Uh, what does, what does that mean, alternate?|qw	A|Well, it's,|%
B|Where do you live?|qw	A|In Plano.|sd
A|Where do you live?|qw	B|In Dallas.|sd
B|So, how do you feel about capital punishment?|qo	A|Well, it's,|%
A|How about you?|qo	B|Oh, I'm pretty much for it.|sd
A|How about you?|qo	B|Well, I guess, you know, I, I guess I can see it from several different perspectives,|h
A|What are yours?|qw	B|China painting and ceramics.|sd
B|What part of Ohio are you in?|qw	A|We're in the I'm in the suburb of Cleveland|sd
A|Now, do you, where did you first get your lessons from?|qw	B|In Abilene, Texas.|sd
A|What school are you going to?|qw	B|N C State.|sd
A|And what field of study are you in?|qw	B|Um, it's actually in computer science|sd
A|Oh. Well, what took you to North Carolina?|qw	B|Oh, um, the service.|sd
B|What kind of grant was it?|qw	A|Well, it was called a B E O G, a Basic Equal Opportunity Grant|sd
A|What, what do you feel is the, the major change that's been going on?|qw	B|That's a tough question.|sv
A|What, what grade do you teach?|qw	B|Six, seven and eight.|sd
B|What's your favorite T V show?|qw	A|Oh. You know, I used to like ST. ELSEWHERE.|sd
A|and how old are you?|qw	B|I'm twenty-eight.|sd
A|What time is it there?|qw	B|Uh, it is twenty minutes to nine.|sd
A|What else do you like?|qw	B|Uh, let's see, I like a lot of different shows.|sd
A|But what practical steps could could one take? Um,|qw	B|By, by having a, a, a budget that is, is feasible, that is reasonable.|sd
A|and,   and how will you,  make that actually happen?|qw	B|Oh, of course.|ba
A|Well, what's your favorite baseball team, Rita?|qw	B|Well, I suppose I'm supposed to say the Rangers, right|qy
A|How do you expect them to do this year?|qo	B|Yeah|b
B|What did you think of the World Series?|qo	A|Well, I'll tell you.|^h
B|What do you think going to happen to the Rangers?|qo	A|Well, I I would like to assume that they're going to do, do better this coming year,|sd
A|Well, how do you feel about capital punishment?|qo	B|Well, I, I just last Friday got off a capital murder case.|sd
B|What kind of a car do you have now?|qw	A|Right now I have a eighty-seven Cavalier.|sd
A|What's everybody drive up there?|qw	B|Uh, in Kenosha?|qy^d
A|how, how cold is it there?|qw	B|Well, actually, it's been warm,|sd
A|But, um, so what, what is your dream car?|qw	B|Uh, I haven't really thought about it.|sd
A|What's your favorite color?|qw	B|Uh, for a car?|qy^d
A|So, what kind of car do you drive right now?|qw	B|Uh, it's a Sky Hawk Buick.|sd
A|What do you have|qw	B|Uh, I've got an Omega|sd
A|What did you do, put it together?|qw	B|Yeah,|ny
A|What do you use it for?|qw	B|Huh?|br
A|What do you use it for?|qw	B|Uh, work,|sd
A|What kind of programs do you,|qw	B|Uh, anything|sd
A|Who is that?|qw	B|Uh, his name is T Q or something like that.|sd
A|And where are they at?|qw	B|Uh, do you know where, uh, Custer is?|qy
A|Well, how did it go?|qo	B|Well, it went pretty well, uh, other than the fact that we encountered some, uh, problems that you run across in older homes with plumbing, which one thing led to another,|sd
B|How about you?|qo	A|Well, um, well probably the last thing I did was, uh, paint and wallpaper kids room|sd
B|What kind of paint?|qw	A|It was a latex paint, paint,|sd
B|What color is it?|qw	A|It's pink.|sd
B|How'd that go?|qw	A|Well, that was the first time I've ever wallpapered,|sd
B|how about you?|qo	A|Well, I have three,|sd
B|Uh, what do you think about it?|qo	A|Uh, I think it's a real good concept.|sv
B|How long were we supposed to discuss for?|qw	A|Uh, you're supposed to get five minutes.|sd
A|What work are you in?|qw	B|Uh, I, I work for T I.|sd
B|So, what are your favorite shows?|qw	A|Um, I like watching COLOMBO and, um, MATLOCK and QUANTUM LEAP,|sd
A|So. How's your products been?|qo	B|Um, I really haven't had, uh, too many problems.|sd
A|Uh, what's your feeling about that?|qo	B|I agree.|aa
A|How do you keep up with current events?|qw	B|Um, well actually, usually, uh, in the mornings I am getting ready to either go to work, uh,|sd
A|what what channel do you watch or what station?|qw	B|Uh, N B C.|sd
A|What did you think of the coverage of the war?|qo	B|Uh, I I found it very one sided.|sd
B|What  what's making you become more convinced that it might be a  good way of punishing|qw	A|Uh, I guess  I'm, I'm,|%
B|I mean, what do you drive now?|qw	A|Uh, I have a Ford pickup|sd
A|at how  at how many miles?|qw	B|Uh, oh ninety-seven thousand.|sd
A|What did you wear to work today?|qw	B|Um, let's see.|^h
B|Um, how about you?|qo	A|Well, I, um, run a business out of my home.|sd
B|what, now, uh, what particularly, particularly what kind of music do you like?|qw	A|Well, I mostly listen to popular music.|sd
A|How about you?|qo	B|Well, um, I don't have that, I don't have that are experience to share|sd
A|How do you feel about rap music?|qo	B|Rap.|b^m
A|What do you mean by world music?|qw	B|Well, world music is, um,|sd
A|What part of the country are you from?|qw	B|Uh, Washington, D C,|sd
A|how did you, how did they get you?|qw	B|Um, they , they went through engineering companies,|sd
A|uh, what do you think about, uh, the idea of having volunteer service for everyone?|qo	B|Uh, I think that, uh, really it wouldn't hurt most of the young people of the country to have to go and do voluntary service.|sv
A|The only complication is, is, is how do you fund something like this?|qw	B|Well, a lot of parents fund their children.|sd
A|What would you have these people do if they were brought in?|qw	B|What, into the service?|qy
A|how old is your daughter.|qw	B|Five.|sd
A|When did you first take your, uh, first piano lesson?|qw	B|Uh, probably about first grade,|sd
B|how old are you?|qw	A|Thirty-eight.|sd
A|Now what year are we talking about?|qw	B|We're talking nineteen seventy-eight.|sd
B|how much is it a month?|qw	A|Oh, shoot it's only about ten bucks a month.|sd
B|What kinds of things have you done?|qw	A|Um, well, I've made a lot of baby gifts|sd
A|Oh, what's that?|qw	B|Well, it's an Italian, um, needlework, using, using the uh,|sd
A|What did you, what kind of things did you do?|qw	B|What I did, when I was doing that was mostly pillows, you know, for sofas and so forth,|sd
A|What did you call that?|qw	B|Bargello.|sd
B|how were you decorating the baskets?|qw	A|Oh, basically bows and lace uh, ribbons.|sd
B|What was this project?|qw	A|Um, well, it's a, it's uh, cross stitch,|sd
A|so what kind of movies have you seen, lately, I guess?|qw	B|Um, a lot,|%
A|Well, what other movies have you seen then lately?|qw	B|Oh.|b
A|What was the last comedy you saw?|qw	B|of to Oh gosh what was the last comedy we saw?|t1
B|How about you?|qo	A|I have three.|sd
B|Where do, where do you  live?|qw	A|In Plano.|sd
B|or, how did you do it?|qw	A|Um, they just stayed with different ones of them.|sd
B|Huh?|qw	A|A lot of these lakes and things, if you could find a centrally located, like, say about the same distance for all of you all to come?|qy^d
B|What, uh, what kind of camping is there in Texas?|qo	A|Well, there, there are quite a few, um, parks, I guess, state parks,|sd
A|where have you, uh,|qw	B|Oh, I've been camping for years, not on a regular basis|sd
A|Where, where is Raleigh, in North Carolina?|qw	B|Uh, well, it's, it's, uh, in terms of north, south I would say it's, uh, a little, a little more towards the northern border of the state and pretty much in the eastern half of it.|sd
A|Well, Stephanie, what's your position on gun control?|qo	B|Well, on a scale of one to ten, uh, being ten, no, kind of legislation and zero being, uh, total ban, I probably would lean more towards six or seven.|sd
A|how way back, I mean|qw	B|Like, um, late fifties, early sixties.|sd
A|How far is Houston?|qw	B|Uh, three hundred miles.|sd
B|How about GHOST?|qo	A|We, we saw, an, we liked it|sd
B|How about SILENCE OF THE LAMBS?|qo	A|That's, that's on our list of things to see|sd
B|Whose your favorite actress or actor?|qw	A|Um, don't really know,|sd
A|Which one?|qw	B|FIELD OF DREAMS.|sd
B|uh, who, who was that with?|qw	A|Um, let's see.|^h
B|How about Meryl Streep,|qo	A|Uh, I don't know,|h
B|Who are they going to blow it to?|qw	A|Uh, that's a good question.|sv
A|Um, well, what do you think is, uh, the pollutants, the main pollutants in the air?|qw	B|I have trouble with the chemical plants and things like that I just, uh, I think they put off so much|sd
B|What kind of recycling programs do you have in Rowlett?|qw	A|Um,|%
A|Where are you?|qw	B|In Johnson City, Tennessee.|sd
A|Well why?|qw	B|and we had no problem with it.|sd
A|And, uh, what part of Virginia, uh?|qw	B|Uh, I live down in the south western part of Blacksburg.|sd
A|Where all you guys go?|qw	B|Well, we go to Maine every Fall|sd
B|Where do you go?|qw	A|Uh|%
B|What type of vacation?|qw	A|well, it really depends,|sd
B|What club do you follow?|qw	A|I'm, uh, I'm a big Red Sox fan,|sd
A|so, um, how do think, how do you think we've changed in the last ten to twenty years?|qw	B|Uh, I'm at a little bit of a loss,|sd
A|How long, how long you been in Dallas?|qw	B|Oh, about eight years.|sd
A|What, uh, department do you work in?|qw	B|I'm in semiconductor.|sd
A|So. How long you been with them, since you moved down here?|qw	B|About eight years,|sd
A|What floor?|qw	B|Two.|sd
A|how, how long are we supposed to talk here?|qw	B|I don't know,|no
B|And what do  you think that problem is?|qw	A|And I think a lot of it has to do with the fact that we don't train our teachers very well.|sv
B|So if you were to improve it, what would you do to improve it?|qw	A|Well, I think I would start with a with getting rid of about two-thirds of the administrators. And all the auxiliary personnel. The school bureaucracy that exists mainly to perpetuate itself.|sd
B|what kind of square footage?|qw	A|Oh, I wouldn't know,|h
A|How many kids do you have?|qw	B|We have two,|sd
A|how long have you lived there?|qw	B|Uh, see, it's three,|sd
A|Now, what do you mostly do|qo	B|Well, mostly right now I'm a, I do a lot of sports and stuff like that is my hobbies and do a lot of things with my family as much as possible.|sd
A|How old are they?|qw	B|Uh, I've got a little girl who's six and a little girl that's three.|sd
B|how long have  you lived in North Carolina?|qw	A|Well, not that long.|sd
B|Um, what did you all do?|qw	A|Well, my husband was with, uh, begins to be much clearer, a lot less back ground noise and University of Oklahoma and,  Phillips  University in Enid.|sd
B|Well, how did, how did you get, uh, hooked up with the T I switchboard thing?|qw	A|Um, a gal who works, uh, with T I on this project|sd
A|Uh, what is her name?|qw	B|Her name's Tina|sd
A|uh, how long have they been recycling there in Virginia?|qw	B|Um, actually quite a, a, a while.|sd
B|What do you, what do you think is causing all this,|qo	A|Well,|%
A|what are your views?|qo	B|Well, yeah,|b
A|Oh. Well, tell me, what books have you read lately?|qw	B|Well, let's see,|^h
B|Now, translations, what do you mean, translations of, of,|qw	A|Um, well, where, where, for instance, um, a Baudelaire poem that was written,  in  the French and then has been translated into English by,  various  people.|sd
B|What do you think about it?|qo	A|Well, I, I feel in light of some of the accidents and so forth that have happened lately, that I think there are some occupations that they should, such as the health field, the transportation field, uh,|sv
A|and how do you hold to yours?|qw	B|No,|nn
A|How would you go about organizing a family reunion?|qw	B|Well,|%
A|well, so what is your favorite T V show?|qw	B|Uh, MAJOR DAD.|sd
B|What kind do you like to watch?|qw	A|Probably my favorite is, um, oh,|%
A|How about you?|qo	B|I have four girls|sd
A|Where do you enjoy dining out?|qw	B|Oh, I generally go to the quickie places just because they're cheap.|sd
A|What area of the country do you live in?|qw	B|I'm in Texas.|sd
A|Well, what are some of your, your favorite inexpensive places?|qw	B|Oh, we'll go to them all.|sd
A|Where do you go if you like to have a nice meal out, or a big meal?|qw	B|A nice meal, oh,|^h
A|Where do you go for steaks?|qw	B|It's usually when we're out of town|sd
A|What's your opinion?|qo	B|Well, it's kind of a broad subject, uh,|sv
A|What, what state do you live in?|qw	B|Texas.|sd
A|What do you think about Robin Hood?|qo	B|Well I work for school district|sd
A|What school district do you work for?|qw	B|Richardson.|sd
A|Where do you live?|qw	B|Uh, we live in Plano.|sd
B|Uh, and where you are?|qw	A|I'm in Richardson,|sd
B|So what do you, what kind of hobbies are you in?|qw	A|Well, I'm mother of four,|sd
A|Where in Colorado?|qw	B|I've been to Telluride which is on the west side and, uh, Copper,|sd
B|What about Utah?|qo	A|Haven't been there,|sd
A|where, whereabouts in Pennsylvania.|qw	B|What?|br
A|Where in Pennsylvania?|qw	B|Um, State College,|sd
B|Well, what particularly are you interested in?|qw	A|Well, I just, pretty, uh, little, you know, about everything.|sd
A|But, uh, how do you, how do you, uh, stay aware of most of the current events. Uh, newspaper? T V news, or what?|qo	B|Um uh, well, some of both.|sd
B|so what do you think about the quality of news coverage in America?|qo	A|I think it's pretty darned good,|sv
A|uh, so what do you think about the school system?|qo	B|Well, I think they're, they're having a lot of trouble right now.|sv
A|Uh, why did you choose a private school?|qw	B|Well, I had one that was needed to be able to be moved along at a, at a pace a little faster than he was going to be able to be moved in public school,|sd
A|Then how does he like it?|qo	B|Oh, he's loved it.|sd
A|How big of a school is it?|qw	B|Uh, overall on campus about twelve hundred, but in the upper school, upper four grades, uh, about four hundred and something|sd
B|So what do you think of, of owning a home as opposed to, to renting somebody else's?|qo	A|Um, well before we built our home we were managing some apartments that we were living in,|sd
A|How about yours?|qo	B|It's tiny.|sd
A|Well, like, um, how does it compare to the ones in your neighborhood?|qw	B|Well, they're, it's pretty typical, I mean, it's a very, very middle class neighborhood.|sd
A|What do you think about, uh, uh, convicted, uh,|qo	B|Well, this is an unusual topic.|sv
B|What do you think about it?|qo	A|Yeah,|b
B|How far away do they come from?|qw	A|Uh, they come from, well, they all meet in Portland|sd
A|Um, what type of magazines do you have?|qo	B|We take several at home.|sd
B|what, what magazines do you have at home?|qo	A|Uh, I am currently taking DECORATIVE WOODWORKING, and, uh, COUNTRY LIVING,|sd
A|Where do you work at?|qw	B|I just work at Stop and Shop out there in, in Ogden|sd
B|Now what type of woodworking do you do?|qo	A|Uh, fine furniture.|sd
B|So, what kind of equipment do you have?|qo	A|For woodworking?|qy
A|Well, how do you feel about trial by jury?|qo	B|I feel very uncomfortable with trials by juries recently. Uh,|sd
A|In what way?|qw	B|In that it seems to me that they are swayed more by emotion than, uh, by evidence that's presented.|sd
A|So how  much time do you think you spend with your kids on the average per each day?|qw	B|Oh, I probably spend an hour or two.|sd
A|how old are your kids again?|qw	B|They're two and one.|sd
A|So,  what do you have?|qo	B|I have a Pontiac Six Thousand.|sd
A|how old is the car?|qw	B|Uh, eighty-seven.|sd
B|So, how do you feel?|qo	A|Well, I'm a little bit ambivalent.|sd
B|How do you feel about Haitian immigration?|qo	A|Uh, that's one of the few things I guess I found myself in agreement with Pat Buchanan|sd
B|How strong is it?|qw	A|It's strong enough for any job where you don't try to take more than say three-eighths of an inch at a time.|sd
A|What do you all do?|qo	B|Uh, we've, we've, uh, taken how much we have, you know, write down how much we have coming in each month|sd
A|What are you all trying to do long term.|qw	B|Huh. Oh it's long term.|^h
A|How do you usually keep up with current events?|qw	B|Normally I listen to C N N or HEADLINE NEWS about an, hour a day,|sd
A|how about you?|qo	B|On the whole, I'm pleased when I have an opportunity to hear just the facts.|sd
A|What did you think of the news coverage of the war?|qw	B|Well, I almost felt like it was too much.|sd
A|Well, how do you feel about it?|qo	B|Well, uh, I don't have any strong convictions about it,|sd
B|Well, how long you been in San Antonio?|qw	A|I've been here for, um, just almost, well, no, almost four years.|sd
B|How many times have you talked?|qw	A|Oh, probably five or six.|sd
B|What other topics have you had?|qw	A|Um, I've talked about camping with someone.|sd
A|Where do you live?|qw	B|Uh, in the Houston area.|sd
A|the question was, uh, what kind of books do you read for entertainment, uh, uh, I guess,|qw	B|Oh, I just read for escape.|sd
A|What, uh, what kind of,|qw	B|Well, I just finished, just, I just finished one last night. A great book.|sd
B|So, what's the latest one you've read?|qw	A|Well, I tell you what,|^h
B|Why Kingsley, Iowa?|qw	A|Well, because that's where my folks all came from.|sd
A|What do you use?|qo	B|Well, I have an, I, I B M P S two, model thirty.|sd
B|What do you like to read?|qo	A|Um, well um, I'm a, I'm a counselor, a therapist by trade,|^h
A|What kind of things have you read?|qw	B|Oh, I read all kinds of things for, um, helping people survive a divorce.|sd
B|what would you recommend?|qw	A|Um, as far as dealing with divorce?|qy
B|How did you get involved?|qw	A|My wife has been working for T I.|sd
B|How do what do you think about it.|qo	A|I think it's justified.|sv
B|How about you?|qo	A|Uh, we try to go once, maybe twice a summer. Uh,  we, uh, just, you know, for  like a short weekend or something.|sd
B|where are you?|qw	A|I'm in Garland.|sd
A|Where at?|qw	B|It is beautiful.|sv
A|Now, how old are your girls?|qw	B|Eleven and fourteen.|sd
A|How many have you made so far, calls?|qw	B|I, I haven't made any.|sd
A|How many have you had so far, do you know?|qw	B|I think I've had about four.|sd
B|what do you think about it?|qo	A|Well I, I guess it's pretty good.|sv
A|What, what is your suggestions?|qw	B|The educators need to be a little bit more open minded as well as innovative in dealing with, uh, the various students to get the maximum potential out of the person.|sv
B|What, what type of history class is it that you're having to take?|qw	A|Uh, American History.|sd
A|Um, on a, if you're doing it on a regular basis, how often do you go?|qw	B|I try to make it at least three times a week.|sd
A|Which one do you feel is better, since you use them both?|qw	B|Um, I get bored very easily.|sd
B|And how much shrimp would you use?|qw	A|Two pounds.|sd
B|Now, how many could you serve?|qw	A|Okay.|^h
B|And, and where did you say you were from?|qw	A|Louisiana.|sd
B|Now how do they do the blackened?|qw	A|You buy it, you buy it as a seasoning.|ad
B|Why didn't it work last time?|qw	A|And why didn't it work last time?|b^m
A|Uh, so, Jack, what type of music do you like?|qo	B|Well, I like, uh, classical, and, uh, sort of, uh, popular rock type music. Uh,|sd
A|How about popular music?|qo	B|Yeah.|^h
A|How about you?|qo	B|Well I, I certainly hope so.|sd
B|Well, then why did he say that during his campaign?|qw	A|Oh, he, he he gave it,|sv
A|What do you mean?|qo	B|Well, with the minorities and we are saying we have lower voter turnout.|sv
B|How much was the alternator?|qw	A|Uh, I something like sixty-nine dollars, something on that order.|sd
B|How did you put that many miles on it, in, four or five years?|qw	A|Um, well, I used, I used to work, uh,|sd
A|So where was your last vacation?|qw	B|Uh, actually my last vacation was in Connecticut.|sd
B|So where have you been?|qw	A|Oh I've I've been lots of places.|sd
B|Where else have you been?|qw	A|Uh|^h
B|Now when was that, when were you there?|qw	A|Um, August, eighty-eight.|sd
B|How old is she?|qw	A|She's only about, uh, uh, a little less than two years old.|sd
B|Where did you go to school?|qw	A|Uh, University of Mississippi.|sd
B|which group do you work in in T I?|qw	A|Um, uh, the computer science center.|sd
B|Oh, uh, where is that at?|qw	A|Uh, north building.|sd
B|How long do you work for T I?|qw	A|Uh, about three years.|sd
B|What about yourself?|qo	A|Well, my parents are both in their seventies.|sd
B|Where is it going to be?|qw	A|Down at Lake Texoma lodge.|sd
B|How many people, Jim, are involved?|qw	A|Uh, generally, uh, I think it's been as high as about a hundred and twenty people.|sd
B|When he retired?|qw	A|Yeah,|ny
A|How old are you?|qw	B|Um, I'm twenty.|sd
A|Well, how long have you been here?|qw	B|Well, we've been here since January,|sd
B|Well, where do you take those things?|qw	A|Well, the, um, glass and the newspaper we usually take to Walmart.|sd
B|And how big do they get.|qw	A|Ours is, uh, on the small end,|sd
B|And how do you spell that breed?|qw	A|It's B I C H O N F R I S E.|sd
B|And how do you pronounce that?|qw	A|Bichon Frise.|sd
B|And about how much are they?|qw	A|Well, they range,|%
B|And how about the, And how about the person in, uh, Houston?|qw	A|Well, she's no longer breeding them|arp_nd
B|So, what do you think about it?|qo	A|Well, I found it interesting that they started off with a problems of immigration in America and then went back and said, well, if there is a problem, what should we do about it?|sd
B|so where did your parents come from?|qw	A|Uh, Poland.|sd
A|What do you think about that?|qo	B|Um, I think that's all right.|sv
A|Well, what do you think about,|qo	B|Yeah.|b
A|What do you think about that?|qo	B|Um,|^h
B|Uh what kind of books do you read?|qw	A|I read, uh, a lot of Steven King, Dean R Koontz, uh some Danielle Steel.|sd
B|Oh, like what?|qw	A|Uh, like THE GRADUATE by Steinbeck.|sd
A|What kind of books do you like to read?|qw	B|Uh, well, a bunch of stuff, I guess, uh, fair number of novels, but mostly shorter ones.|arp_nd
B|Now what's that?|qw	A|It was, uh, during Teddy Roosevelt's time. And, uh, about a American woman that got kidnapped in, uh, Morocco.|sd
B|What, how crazy?|qw	A|Well, just like some, one quote that he had was that he thought the America's emblem was stupid because it was an eagle,|sd
B|Well, how much do you like lawn and garden work?|qw	A|Well, uh, even though it's totally out of my, uh, my degree training, I've been working as, as, in the horticultural aspect, so the last, I don't know, fifteen, twenty years, so Uh, I'm,|arp_nd
B|What do you do?|qo	A|Well, I work for the state as, as a grounds keeper.|sd
B|So what's it been like up there?|qw	A|Well, for the past week or two it's been cold and wet|sd
B|What, uh, school are you going to?|qw	A|Um, I'm at B Y U.|sd
B|Leslie, what are you studying?|qw	A|Nursing.|sd
A|Um, what about you?|qo	B|I'm, I'm single,|sd
A|How do you dress?|qo	B|Well, I'm a drafter,|^h
A|What advice would you give?|qw	B|What advice.|b^m
B|what have you seen lately?|qw	A|Well, uh, CITY SLICKERS, and STAR TREK FIVE.|sd
A|How about yourself?|qo	B|I just saw the latest one.|sd
A|How is it?|qw	B|It was fantastic.|sd
A|Why?|qw	B|Uh, William Shatner wrote it.|sd
A|What other movies have you seen?|qw	B|Uh, saw THE ADDAMS FAMILY last week.|sd
A|Oh, how was that?|qw	B|It was pretty good.|sd
A|What about you guys?|qo	B|Well, we, uh,|%
B|Well, I guess, what part of what part of the country do you live in?|qw	A|I'm in Dallas, Texas.|sd
A|What about yourself?|qo	B|Well, I'm also in Dallas.|sd
B|How about you?|qo	A|Well, I am, uh, I'm, gosh, I'm barely in Dallas.|sd
A|How much time do you spend with your children?|qw	B|Very little. Because they're grown.|sd
A|What?|qw	B|Sometimes that's okay.|sd
A|How did they end up so far away?|qw	B|Well, that is, that's, the, the, my little pair. And my second marriage.|sd
B|And actually, that one, the, the, the taxes on gasoline don't, don't bug me as much as, uh, uh, what are we, eight and a quarter percent sales tax?|qw	A|Yep,|ny
B|what do you think of that new luxury car tax, anything over ten or thirty thousand dollars?|qo	A|Well, you know, like other things, if they don't affect you, you don't worry about them too much.|arp_nd
B|Well, what, what about the taxes on cigarettes?|qo	A|Well, tell me about your home.|ad
B|How big a lot do you got it on?|qw	A|Ten acres.|sd
A|Uh, what sort of camping do you like to do the most?|qo	B|Uh, well, I, I do, uh, real rough type camping.|sd
B|How about you?|qo	A|Well, so far my wife and I have pretty much had to stick with tent camping.|sd
A|Anyway, Uh, what do you figure has been the longest trip you've taken camping?|qo	B|Yeah.|b
B|What about  you?|qo	A|a matter of choice, or compulsion?|qy
B|and, What about you all?|qo	A|Yeah.|b
A|How old are your kids?|qw	B|Oh, from fourteen down to seven.|sd
B|You sound like you've got some small ones in the background.|qo	A|One.|sd
B|Where are  you from?|qw	A|Uh, originally?|qy
B|What are you,  what are you studying there at Heidelberg ?|qw	A|Computer engineering.|sd
B|What year?|qw	A|Uh, just finished up my fourth semester.|sd
B|or a house somewhere, what would you get?|qw	A|Uh, well, um, first off we'd probably wind up with a, a cat or maybe a puppy.|sd
B|So,  so, to make one successful, I mean, I mean what do you all do.|qo	A|Oh,|^h
A|Where is home for you?|qw	B|Originally, uh, I, uh, was born in Missouri.|sd
A|Um, what type of things do you do as a family to spend time together.|qo	B|Oh, we spend a lot of time outdoors jogging, bicycling, uh, going to the park, um, some time watching V C R movies um, generally cheap things|sd
A|Oh, now where do they live?|qw	B|In Arizona.|sd
A|Uh, what are the ages of your kids then?|qw	B|They range from twenty-four to five.|sd
B|How old are your children?|qw	A|We have,|%
B|Where, where in Dallas?|qw	A|Well, uh, no,|ar
A|How's the weather out there in Georgia?|qw	B|Yeah.|ny
B|Um, how about yourself?|qo	A|Well, yeah,|^h
A|So how is that?|qw	B|Um, it, they call it a low impact aerobics,|sd
B|But, um, so how, how successful is your exercise video?|qw	A|It is amazing how fast you take off the inches|sd
A|And how did you feel it went?|qo	B|It went pretty good.|sd
A|Well, what did you find was most helpful in planning the birthday get together?|qo	B|Um, the, probably the biggest challenge was getting a place where everyone, you know, could eat comfortably and, and everything, uh.|sd
A|Now how old is she?|qw	B|Uh, she's eighty-six.|sd
A|How do you feel about gun control?|qo	B|Well, uh, I mean I don't think that guns should be outlawed|sv
A|So, Julie, how do you feel about AIDS research?|qo	B|I think we need, we definitely need more of it, definitely.|sv
B|What do you think about that subject?|qo	A|I think it's, I think it stands a really interesting question of, uh,|sv
A|Well what do you feel about the, um, present situation in the Mideast?|qo	B|Well, it looks like it's just about as volatile as it usually is.|sv
B|What do you think, Mark?|qo	A|Yeah,|aa
B|what about this situation with the, you know, the, uh, continual, uh, harassment by Iraq right now and, uh, apparently failing to let the, uh, arms inspectors have free access.|qo	A|Uh-huh.|^h
A|So, uh, what things do you consider an invasion of privacy?|qo	B|Ooh, well I don't know.|no
B|What do you think?|qo	A|Oh, I don't know.|no
B|Well what about,  uh, required drug testing, uh, as a, uh, condition of employment?|qo	A|Yeah,|^h
B|So what  about that as an invasion of privacy?|qo	A|Yeah.|^h
B|What is it that you are, you know, particularly  upset about?|qw	A|Uh,  I guess, uh, I think they've lost their compass|sv
B|What do you feel that your kids are getting in the parochial schools that they wouldn't get in a, the public school system?|qo	A|Well, one hundred percent of the, uh, customers care.|sv
B|what ages?|qw	A|Well, twenty-seven up.|sd
A|And how about yourself?|qo	B|I have a four and a half and a three.|sd
B|What was the age difference between the youngest and the oldest?|qw	A|Six years.|sd
B|what?|qw	A|Discuss everything that didn't agree with them.|sd
B|Oh,  why is that?|qw	A|Well, my, my, uh, two of my, uh,|%
A|So how do you feel about it?|qo	B|Uh, I, I don't see any problem with, with testing for random drugs.|sv
A|Where do you work?|qw	B|Uh, well I'm a graduate student right now at Carnegie  Mellon.|arp_nd
A|What, what program are you in over at Carnegie Mellon?|qw	B|Uh, electrical engineering.|sd
A|Uh, first, um, I need to know, uh, how do you feel about, uh, about sending, uh, an elderly, uh, family member to a nursing home?|qo	B|Well, of course, it's, you know, it's one of the last few things in the world you'd ever want to do, you know. Unless it's just, you know, really, you know, and, uh, for their, uh, you know, for their own good.|sv
A|Where's that.|qw	B|That's on Plano Road,|sd
A|What are you afraid of with them?|qw	B|What am I afraid of?|qy
A|How old are they?|qw	B|um, four and two and half.|sd
A|Well, where are you?|qw	B|In Plano.|sd
B|Oh, what's he teach?|qw	A|C V A E.|sd
B|So, what do you do?|qo	A|I teach,|sd
B|How long you taught, taught in Dallas schools?|qw	A|Uh, this is my eleventh year.|sd
B|So, how long are we suppose to talk for?|qw	A|Well, you can talk for ten minutes|sd
A|What would you serve, uh, if you were having a dinner party?|qw	B|Oh, gosh, all the other,|%
B|And, how old are your kids?|qw	A|One is eight|sd
B|Who is the, is the author?|qw	A|Don't, don't ask me|no
B|So, who's your, uh, favorite team?|qw	A|Who do you think?|qh
A|Um, who is it, Michael Irvin|qw	B|Uh-huh.|ny
A|Thirty day notice for what?|qw	B|Um, I'm done, where I work.|sd
A|So other than the Vikings, who do you like?|qo	B|Um, actually, when I was younger, I was a Cardinal fan, too.|arp_nd
B|What are they going up to, thirty bucks or something?|qw	A|Thirty, or thirty-two for really good tickets.|sd
A|Um, what do you do this weekend?|qo	B|Well, uh, pretty much spent most of my time either in the yard or at nurseries buying stuff for the yard.|sd
A|what do you plan, have planned for your yard?|qo	B|Well, uh, we just bought our house, uh, last July,|sd
A|What part of the state do you live in?|qw	B|Uh, I live in Dallas.|sd
A|How do you put trees in there?|qo	B|Uh, you just, we're just happy that there's trees already there so far,|^h
A|Like what, um, what type roses?|qw	B|Uh, different, uh, a few different, uh, hybrid tea type varieties.|sd
A|But, uh, but, uh, what kind of, uh, what kind of, what kind of grass are you growing?|qw	B|It's, uh, bermuda.|sd
A|Well, how, how do you feel about the immigration laws?|qo	B|At,|%
B|What do you have, at home?|qo	A|We have an, um,|%
A|What type of lawn and garden work do you do?|qo	B|Well, I do it all|arp_nd
B|What have you got growing right now?|qw	A|Uh, got,|%
A|How about you.|qo	B|Um, the only exercise program I'm doing right now is walking.|sd
A|well what do you think?|qo	B|Well, I'm kind of leaning towards, I don't know, I'm thinking about what, from one to ten what my no would be.|sd
A|What kind of lawn and garden work do you do?|qo	B|Well, right now the place where I'm living, the yard was basically neglected for about the last twenty-five years,|arp_nd
A|What have you done?|qw	B|Killing lots of fire ants.|sd
A|How did you get rid of them?|qw	B|Uh, Dursban Two.|sd
A|What?|qw	B|Powdered sulphur.|sd
A|Hm, I wonder why it does?|qw	B|You, you don't have to put a whole lot out,|sd
A|Where do you all live?|qw	B|Uh, in Missouri City.|sd
A|what kind of car are you thinking about buying next?|qw	B|Well, what a what do we currently have,|t1
A|What year?|qw	B|Eighty-eight.|sd
B|so, what's your next purchase supposed to be?|qw	A|Well, I know this,|%
B|if you had a choice of your car, what would you get?|qw	A|Well, it's, this is going to sound really strange,|arp_nd
B|Wonder what happened.|qw	A|I don't know,|no
A|What do you think about the, uh, Peace Corps or public service commitment?|qo	B|Uh, that's the first I've ever heard of it.|sd
B|What's, what's your most recent one that you've seen?|qw	A|Well actually, what I do,|%
A|what type of movies do you like?|qo	B|Um, action|sd
A|What was your favorite all time movie?|qw	B|Um, oh gosh, I I can't think off my head.|^h
A|What if you're looking down the barrel of a hand cannon?|qw	B|Then it's still equally matched.|sv
A|What if, uh, what if you think someone's trying to hurt them and you make a mistake?|qw	B|This, this is where the question of gun control comes in.|sv
B|What kind of a dog is he?|qw	A|Um, he's part golden Lab and part, uh, let's see, Alaskan, no, not Alaskan.|sd
B|How long have you had him?|qw	A|Oh, about two years.|sd
A|How do they get along together?|qw	B|Pretty good.|sd
B|Well, how did he get out?|qw	A|He dug a hole under the fence.|sd
B|How are your kids handling it?|qo	A|Well, I don't know if it's quite hit him, hit them.|sd
B|what was the results there.|qw	A|Oh, he was found guilty,|sd
A|Oh, what is the name of that?|qw	B|Uh, it's called Paveway.|sd
B|Whereabouts?|qw	A|In Allendale .|sd
A|What was, what was your name again?|qw	B|Well, I,|%
A|Tell me, what are some of the things that you did with your children when they were growing up?|qw	B|Oh, well, uh, when they were little, we did lots of reading and playing and going to parks, and things of that sort,|sd
A|well, Myrna, how do you get your news, news?|qw	B|Uh, most of it is from the radio, uh, and also from the news programs that we watch in the afternoon.|sd
A|what did you think about the coverage like over in the, uh, Persian Gulf?|qo	B|I think they did a great job.|sv
B|How can you even think like that?|qo	A|it is, yeah, isn't it something?|qh
A|Um, what do you think the major cause of air pollution or at least in the Boston areas,|qo	B|Well, the, the, the major cause it seems up here is|sd
A|I mean you know what it's like here.|qw	B|Oh, yeah,|ny
A|So what movies have you seen lately?|qw	B|Well, I saw, um, lately I've seen SOAP DISH.|sd
A|how do you mean?|qo	B|Well, it was,|%
B|What did you think about DANCES WITH WOLVES when you saw it?|qo	A|Well, okay,|b
A|why do you think that it's less close than it used to be?|qo	B|Well, I, I just think that, uh, you know, at that|%
A|Um, how do you like it?|qo	B|Well, I don't do much of it here.|arp_nd
A|Oh, what kind do you have?|qw	B|Oh, roaches and,|sd
A|Well, how about when you were in Colorado?|qo	B|Well, I liked it a little bit|sd
A|So what is your house like?|qw	B|It's a two bedroom, two baths duplex.|sd
B|how many bedrooms is it?|qw	A|Well, they advertised it as a three bedroom house because it has a built on addition room, you know|arp_nd
B|And how old's the youngest?|qw	A|She's three and a half|sd
A|Well, what are the colors in your house?|qw	B|Uh, um, kind of a mauve and gray.|sd
A|What, what do you think about them?|qo	B|I think they get a lot of people in trouble.|sv
B|What's that?|qw	A|They're giving us a lot of time|sv
A|So, uh, what was the last car repair you had?|qw	B|Just recently I was kind of laughing when I, when I heard the switchboard talking about the question because, uh, I had to have my, uh, radiator flushed|sd
B|What about you?|qo	A|Oh, I guess it's been awhile for me.|sd
B|How old are you Lisa?|qw	A|I'm twenty.|sd
A|How old are you?|qw	B|I'm older.|sd
B|and where are you from, where are you calling from?|qw	A|I'm calling from, uh, Provo, Utah,|sd
B|Anyway, so, where's your favorite place to go?|qw	A|My grandparents live there.|sd
B|Where in Arizona?|qw	A|Uh, Tempe.|sd
B|What do you like about Tempe?|qo	A|Uh, mainly just being with family is it.|sd
A|Where, where do you live?|qw	B|We, I live in Yakima, Washington.|sd
B|So, where, have you skied?|qw	A|And it's, it's kind of nice being up here just because it's all like a vacation in itself when you get to go.|sd
B|What are you studying?|qw	A|Nursing.|sd
A|How long did you get to stay there?|qw	B|Uh, six weeks.|sd
A|What kind?|qw	B|Yeah.|ny
B|what kind of system do you have?|qw	A|It's, uh, uh, I guess excuse me, just a standard. Uh, with the, uh, all the doors and the, uh, infrared thing, you know, motion detector. Pretty standard.|sd
B|And what if a burglar comes along and cuts your phone line?|qw	A|Well, it's got a back up system that doesn't work supposedly. uh, that if it's cut supposedly it notifies them anyway Supposedly.|sd
B|How does it do that?|qw	A|Who knows, you know.|no
B|And what do you have?|qw	A|Well, my husband,|%
B|And how old are your girls?|qw	A|They're eleven and eight|sd
B|Uh, how do you feel about taxes?|qo	A|Well, it seems like a big politics game|sv
B|So how many, um, credit cards do you have?|qw	A|Um, I think I'm down to one.|sd
B|How, how do you use it?|qw	A|Emergencies come along,|sd
A|So, how do you feel about capital punishment?|qo	B|Well, I, I'm not really certain how I, uh, I'm not certain that, that it does a lot of good. I mean, that it ends up, ends up effectively, uh, uh, uh, avoiding a lot of the crimes that have capital punishment  penalties.|sd
B|What about yourself?|qo	A|I, uh, I have the same dilemma, I think. Uh,|sd
A|What state are you in?|qw	B|I'm in Texas.|sd
B|Where, where are you calling from?|qw	A|Uh, right now I'm in Utah,|sd
A|So, uh, uh, what are the laws like in Texas?|qw	B|It's, Texas is, has, is one of the, one of the well,|%
A|What do you have now?|qw	B|I've got a, uh, a Dodge Daytona.|sd
B|What is it?|qw	A|Uh, mine is a Honda Accord.|sd
B|Uh, what, what rental agent did you go to to actually rent to rent those kind of cars.|qw	A|Um|b
A|How did it go for you?|qw	B|Oh, well, it's, uh, it's worked.|sd
A|So, uh, what kind of home repair work have you done?|qw	B|Well, um, done a little, uh, repair on the, uh, shingles on the roof recently.|sd
B|What kind of roof do you have?|qw	A|Uh, we're in, uh, campus apartment buildings with flat top, uh.|sd
A|What do you use to keep from sliding off that rascal?|qw	B|Well, uh, you wear, uh, shoes with good traction, and, and, and try to remember where you are at all times|sd
B|What age are your children?|qw	A|I have a five and a half and a three and a half year old that play with them|sd
A|So, uh, what do you think about child care|qo	B|Oh, well, my, my feelings on it is, uh, I wouldn't take a child to day-care You know?|sd
A|how come you wouldn't take them to a day-care?|qw	B|Uh,|^h
B|How was it?|qo	A|Well, I think they had a, they had two teachers|sd
A|So what do you feel are the current trends in the way families spend time in general, you  know, in America?|qo	B|I, I think a  lot of people, a lot of people set their kids in front of the T V and H B O and rent movies and,  and,  kind of leave them to their own means.  Um,|sv
A|How about yourself?|qo	B|Uh, we have two and another one on the way.|sd
B|Oh, well what do you do with your seventh grader?|qw	A|Well, she is into a little bit of everything.|sd
A|What kind of work do you do?|qw	B|I'm a nurse.|sd
B|What do you use yours for mostly?|qw	A|Um, mostly, um, word processing applications and, uh, just as a dumb terminal.|sd
A|Um, what do you find that you use yours mostly for?|qw	B|Well, I do a lot of word processing and spreadsheets and data base,|sd
A|Well, see, what do you do?|qw	B|I, uh, do, uh, consultation and, and testing of various kinds for, uh, English as a second language programs.|sd
A|Um, so, um, what were you doing when you were using an Apple two E?|qw	B|Well, I was doing some of the same stuff, but doing it more slowly and with smaller files.|sd
A|Where do you find places to camp?|qw	B|Well, uh, we, we do a lot of canoeing when we go camping|sd
B|How about yourself?|qo	A|Well, um, I've done, oh, I would say quite a bit of camping, mostly with my husband and I.|sd
A|Oh, and what does that consist of?|qw	B|Uh, it's just a piece of material that has, uh, that has a lot of places where you can tie off to it and make it into a tent uh, like a, uh,|sd
A|music do you like?|qw	B|Uh, lots of different kinds I guess.|sd
A|What part of Texas you from?|qw	B|Uh, Nacogdoches.|sd
A|whereabouts is that?|qw	B|That's between Houston and Dallas.|sd
A|what, what major city is nearby?|qw	B|Houston.|sd
B|What kind of, what lake do you all use?|qw	A|Well, he, uh, he's from Detroit|arp_nd
A|But, yeah, so, what do you do for a job?|qw	B|Uh, I build transformers.|sd
A|how do you like it down there in Texas?|qo	B|It's real nice.|sd
B|so what kind of luck you been having with buying and returning products?|qw	A|Uh, not too bad really.|sd
B|What  part of California  are you from?|qw	A|San Jose,  California.|sd
B|Uh, what about you?|qo	A|Well, I don't have so much trouble with products as service.|sd
B|So, uh, what are your, what are your thoughts on the subject there?|qw	A|Well I definitely think, like decisions have to be unanimous.|sv
A|What do you think about capital punishment?|qo	B|Well, I'm kind of in favor of it for certain crimes.|sd
A|Which crimes do you feel that?|qw	B|Well, I think first degree murder, uh, probably warrants it.|sv
B|What do you do Georgeanne?|qw	A|I'm a graduate student at the University of Texas in Dallas.|sd
B|What program you in?|qw	A|Uh, audiology.|sd
A|What do you do?|qw	B|I'm a doctoral student at the University of Central Florida.|sd
A|How do you feel about public schools?|qo	B|Well, our public schools are, are really poor, I feel.|sv
B|How about you?|qo	A|Well, that's interesting.|sv
A|What  do you think's wrong to cause  that?|qo	B|Well,  well, for one thing there's not enough money in the school system.|sv
A|How about you?|qo	B|Well, I'm, uh, I, I was just, uh, in high school I guess when it, when it ended.|sd
A|Well, what do you think in terms of, uh, benefits?|qo	B|Well, personally, you know, I think, you know,|%
B|Where do you live?|qw	A|I live in San Antonio.|sd
B|how do you feel that it should be applied?|qw	A|Well, I I just feel like there's a lot of murderers and rapists, and everything else, just walking the streets. You know?|sv
A|What are some of your favorite foods?|qw	B|Mine, well,|%
A|What do you, what other, what dishes do you serve with it?|qw	B|Well, basically, it's, what we call it impenadas which is, which is, like,|sd
B|What kind of fish?|qw	A|Um, any white fish.|sd
B|Uh, how much, uh, how much pork do you buy for two people.|qw	A|Um, well,|%
B|And how much does it cost?|qw	A|Um, the hoi sin sauce?|qy
A|so what kind of cars are you looking at?|qw	B|Well, we've, uh, we've, we've test driven the Oldsmobile Delta Eighty-eight and a Cutlass Supreme and a used Cadillac, about three or four years old because, uh, I get married in a couple of weeks|sd
A|What kind of car is it?|qw	B|It's a, a Buick Century.|sd
A|what kind of hobbies do you have?|qo	B|Um, mostly what I do,|sd
A|What types of crafts do you do?|qo	B|I do a little bit of woodworking,|sd
A|Oh, what kind is it?|qw	B|He's a mixed breed,|sd
B|Um, how, how old is your child?|qw	A|Five|sd
B|What color are they?|qw	A|Uh, the female's red|sd
B|What about your home?|qo	A|Well, right now we're just renting,|sd
A|Well, what do you think about it?|qo	B|Well, um, most of the stuff up until now, in the recent months, I, I, I don't have any problem with.|sd
B|What was the reason why somebody was trying to find out all that stuff?|qw	A|It was just as a demonstration to show those who were watching it how easily obtainable information is on any single person.|sd
B|Hum, what do you think could be done about it?|qo	A|Uh, the only way it can change is, um, if, if everybody bands together.|sv
B|what do you use yours at home for?|qo	A|Well, that's actually a good question.|arp_nd
B|How do you go about getting one of those a catalogs?|qo	A|They're available in, you know, the B Daltons, that that type of thing.|sd
A|What, what, for instance, what are you,|qw	B|Um, oh,|%
A|Jay, where do you live in Texas?|qw	B|I live in Dallas,|sd
B|What's your house like?|qw	A|Cape Cod style, I guess you'd call it.|sd
B|How big is your place?|qw	A|It's, uh, oh, about twenty-five thousand, twenty-five hundred square feet,  I guess.|sd
A|What college are you teaching at?|qw	B|I'm at, uh, one of the uh, it's called Brookhaven College.|sd
A|what are your suggestions in making a family reunion successful|qw	B|Have a big family, I guess,|sv
A|well how old are you?|qw	B|Twenty-five,|sd
A|Now how long in advance do they, uh, let them know?|qw	B|Well, we plan on it,|arp_nd
A|where in Indiana?|qw	B|Lafayette.|sd
A|uh, when is your next one, uh, scheduled now.|qw	B|Well it's like, the last one was my high school graduation|sd
B|What, what changes do you think have taken place in the last generation?|qw	A|I guess the biggest one is number of women in the work force.|sv
A|What do you think?|qo	B|That, that, that,|%
A|About?|qw	B|That as far as|%
A|Oh, where are you from?|qw	B|I grew up most of my childhood in Germany.|sd
A|What kind of vacations do you like?|qo	B|Uh, well my husband and I are scuba divers.|sd
A|What kind of painting are you planning to do?|qw	B|Well I have wallpaper in both of my bathrooms right now which is really pretty disgusting.|arp_nd
B|What, what kind of, what kind of paint do you normally use?|qw	A|Well, uh, we used a latex, uh, wall paint and then a semigloss enamel for the woodwork|sd
A|is that, what is that,|qw	B|Palo Alto.|sd
A|What do you think?|qo	B|Uh, yeah,|aa
A|And what kinds of things do you use it for when you when you go to their houses to them?|qw	B|Um, usually, uh, word processing something, um, such as, oh, forms for things, uh,|sd
B|What kind of, what kind of things do you write?|qw	A|Well, um, I was a technical writer for many years, um,|arp_nd
A|what, what type of advice do you think you'd give to a, a parent?|qw	B|To a parent?|qy
A|How about your family?|qo	B|Well, in my family, let's see, last October was the forty fifth annual  uh,  reunion.|sd
A|And then where do you meet?|qw	B|Uh, there's a big community hall in Vernon Texas,|sd
A|so what were you saying?|qw	B|Do you work with, do you work around children when you work?|qy
B|How old is she?|qw	A|She's two months now, nine weeks.|sd
A|what do you think and this is not one of our questions but what do you think of this no excuse absentee balloting?|qo	B|No excuse.|^h
A|how many kids do you have?|qw	B|Two.|sd
A|What kind of eating out do you enjoy?|qo	B|Okay.|b
A|What are your favorite places?|qw	B|Um, well, I like Chinese food.|sd
A|now what is your, what's your child's favorite place to eat?|qw	B|Um, favorite place,|^h
A|What kind do you have?|qw	B|We have an I B M compatible.|sd
B|What kind of a computer do you use at work?|qw	A|I have a, a P S one I B M type.|sd
B|How long are we supposed to talk on this?|qw	A|They tell us when we're through.|sd
B|where do you work?|qw	A|I work at Texas Instruments.|sd
B|And you're in what city?|qw	A|I'm in Richardson.|sd
A|Well, what are you doing way in Washington?|qw	B|Well, we're actually all from Nebraska.|sd
B|What, uh,  grade is your daughter in?|qw	A|My, my daughter's in the, um, fourth grade|sd
A|Well, what do you know about Latin American policies?|qo	B|Well, I think they're kind of ambivalent, really.|sv
A|Well, what do you think of, uh, this, uh, U S free trade agreement we're working on with Mexico?|qo	B|Well, I think it's long overdue|sv
A|Well, let me just start by asking what you think of this Middle East affair we've got going on?|qo	B|I think that it's time that we concentrate more on what's going on within our own borders than what's going on in the Middle East.|sv
A|The break ups?|qo	B|I think that's great.|sv
A|and, uh, when did you guys vote him into office?|qw	B|Oh, unfortunately nineteen ninety.|sd
A|well what do you do on your yard?|qo	B|Well, uh, typical lawn stuff.|sd
A|What did you grow?|qw	B|Well, I had, uh, tomatoes and, and, uh, uh, peppers,|sd
B|So, what part of Mississippi are you from?|qw	A|I'm from Laurel.|sd
B|Whereabouts is that?|qw	A|That's way down towards the south.|sd
A|How much of a golfer are you?|qw	B|Are you a hacker?|qy
A|What are you guys having for Christmas?|qo	B|What are we having?|^h
B|Oh, well, how many people are you planning on serving at Christmas?|qw	A|Oh, well, we're, you know, we're not going to eat the  whole thing|sd
B|what is brisket?|qw	A|Brisket?|bh
B|Well, what else do you serve with your pig?|qw	A|Oh, well, we'll have cranberries and hominy|sd
B|how do you get your main source of current events?|qw	A|Well, uh, until recently I was taking the WALL STREET JOURNAL,|sd
A|Can you think of anything that could be done to make our news media more accurate and objective?|qo	B|I think they need to do a little bit, go into a little bit more depth, uh, before they would just report, like somebody wants to make a statement or something like that,|sv
B|What does that mean, accidental tomatoes?|qw	A|Well, last year the birds came and ate a few of the tomatoes,|sd
A|What are your favorite shows?|qo	B|Well, I, it's doesn't seem like I get enough time to watch much T V,|sd
B|How about you?|qo	A|Um, I like L A LAW not because it's realistic, but it's entertaining.|sd
B|what, what ones do you get into?|qw	A|Uh, I don't even remember|sd
A|How old?|qw	B|Oh, I have a six year old,|sd
A|What vacations have you been on that you like?|qo	B|Um, well I really enjoyed, um,|sd
A|Um, how, how far do you usually end, end up driving just,|qw	B|Um, the furthest I drove was probably Texas,|sd
A|Now where, you're from where? *slash error Oh, Wisconsin.|qw	B|Kenosha, Wisconsin.|sd
A|What vacation have you enjoyed the most?|qw	B|Uh, um. Probably, uh, when we go to Wisconsin .|sd
A|What is it?|qw	B|Um, oh, it's a, like a huge amusement park um, they have water slides|sd
A|How far away is it?|qw	B|Um, from Kenosha, it's about three hours.|sd
B|Where is that?|qw	A|and you have to kind of get up into the mountains to get much of the greenery.|sd
B|where's that?|qw	A|Uh, Idaho, is where I live,|sd
A|what did you get?|qw	B|I got a Lexus L S four hundred. Which is made by Toyota.|sd
A|Jerry, what did you think of people like, uh, Jane Fonda, another war anti-war activist.|qw	B|I,|%
A|what kind of hobbies do you have Lori?|qo	B|Uh, I guess, I, uh, I like to play golf.|sd
A|Where do you play golf in this area?|qw	B|Well, we live, uh, pretty close, to the Mesquite Golf Course.|sd
B|Where are a student?|qw	A|Uh,|%
A|favorite type of music or musician or any.|qo	B|I don't really have a favorite type.|sd
B|How about you?|qo	A|Oh, I, I'm very, uh, I'm very varied as well.|sd
B|How about you?|qo	A|Well, um, I listen to, uh, specific,|sd
B|What about the blues or something like that?|qw	A|Uh, uh, blues are okay.|sv
B|Uh, what do you feel about come of the things that need to,|qo	A|Damn it , I agree with pretty much with everything you've said.|sd
A|what kind?|qw	B|I have a Schnauzer|sd
A|what was the other dog you had?|qw	B|It's a sheltie.|sd
B|how did they get their reputation, then?|qw	A|Well, because some people, uh, want to train them as,|sd
A|So what do you think about that?|qo	B|Uh, I don't, I don't think they're very accurate|sv
B|How many children do you have now?|qw	A|Well I have five.|sd
A|Why?|qw	B|Um, well, uh, partly due to ownership.|sd
B|How are they coping with it?|qw	A|Well, not very well.|sd
A|Why do we end this thing?|qw	B|It used to, it used to just automatically cut off|sd
A|Why don't we do that?|qw	B|Okay.|fo_o_fw_"_by_bc
A|Uh, well how is it appropriate to be talking about exercise attitudes?|qo	B|We, uh,|%
B|So, and how do you feel about it?|qo	A|Uh, I'm, I am a person who wishes I had more time to exercise.|sd
B|How about yourself?|qo	A|Well, oh, hobbies, gee whiz,|^h
B|Who takes care of that?|qw	A|Well, the thing is, is that I live in a dorm.|sd
B|so how do you keep track of where you are in, in your monthly spending?|qw	A|Well, the thing is, is that, um, I I basically know how much I have, right?|qy
B|Where do you call to?|qw	A|Argentina.|sd
B|What makes you , think so?|qo	A|Any, any, um,|%
B|What are you, what are you studying?|qw	A|I'm doing masters in computer science and computer engineering.|sd
B|And what do you think you'll do with that?|qo	A|With those degrees?|bf
B|And?|qo	A|And hopefully get a job after that.|sd
B|What about when you have breaks like, um, Christmas or between sessions?|qw	A|Well, for example, we had spring break now,|sd
A|what do you like to cook?|qw	B|I like, well I like to cook foods I like to eat.|sd
B|what do you like to, to cook?|qw	A|Uh, we,|%
B|Where in North Carolina?|qw	A|In Raleigh.|sd
A|how'd you find out about this?|qw	B|Uh, I was visiting my son down in Dallas,|sd
A|what do, what do, what do you think we can do to solve the crime in America?|qo	B|Oh, if I knew that I'd be a very wealthy person.|sv
A|but what, what, what are the steps?|qo	B|Well, you have to see,|sv
A|Which one?|qw	B|Drugs.|sd
A|What have you seen lately?|qw	B|Um, actually have been to the movies, um,|sd
A|What state?|qw	B|I'm in Lubbock, Texas.|sd
B|Well, what was her name?|qw	A|Cathy Walker.|sd
B|What are trying to get? *listen|qw	A|A machine that puts back grind tape on and off the waivers .|sd
B|What did you think of Sam?|qo	A|Uh, oh, I like him,|sd
B|So what is it now?|qw	A|It's up to fifty-five on the gold card.|sd
B|But then, what's the interest?|qw	A|Well, now, that's the card, see.|sd
B|Who do you work for?|qw	A|I don't,|sd
B|Where are you going to school?|qw	A|N C State.|sd
B|What's that?|qw	A|Uh, North Carolina State.|sd
B|So where are you?|qw	A|Where am I?|br
B|So what are you getting your degree in?|qw	A|Um, uh, human factors.|sd
B|And what do you do with it?|qw	A|Not a thing|sd
B|Well, what is it?|qw	A|It's, it's really looking at systems and design systems and seeing how people interact with them.|sd
A|what's the solution then?|qw	B|Oh, I have no idea.|no
B|what do you usually wear to work?|qw	A|Well, uh, I am basically retired now.|sd
A|How about you?|qo	B|Well, I work at T I|sd
A|What about the mini skirt?|qw	B|There are a few people every now and then that wear those to work.|sd
A|What have you seen?|qo	B|The latest movie I've seen that I thought was fantastic was DANCES WITH  WOLVES.|sd
A|So, how do you feel about our policy in Latin America?|qo	B|Oh, I'm all in favor of it,|sd
A|So, what's the difference?|qw	B|Idi Amin was, you know, in power for so long.|sd
B|So, who is your favorite football team?|qw	A|Guess.|ad
B|What's that?|qw	A|They're going to go somewhere pretty shortly.|sv
A|Who's, their quarterback?|qw	B|Yeah.|b
A|Who's their quarterback?|qw	B|Uh, Jim Kelly.|sd
B|Who was the quarterback?|qw	A|Well,  They,  had quite a few quarterbacks if you think about it. Uh,|sd
B|Well, when is the, N F L draft|qw	A|But, uh,|%
B|What kind do you have?|qw	A|Um, it's an I B M,|sd
A|What kind of books do you like to read?|qw	B|Oh , I like all kinds of books.|sd
B|How about you?|qo	A|Um, well, I like, like you said, real life, um,|sd
A|What was the last book you read?|qw	B|Uh, jeez,|^h
A|Well, how about who,|qw	B|Like I say, haven't done it in, in such a long time.|sd
B|How many people do you supervise?|qw	A|Uh, about twenty.|sd
A|How, how do you look at counting credit cards?|qo	B|We just, uh, quit using them|sd
B|Why do they do that?|qw	A|It's just another way to make money, as far as I can tell.|sv
A|Do you have any particular thoughts about the school system?|qo	B|or Well, um, I, I think that in, in, uh,|%
A|well what movies do you like?|qw	B|Gosh,|^h
A|How old are you all?|qw	B|Um, we're late twenties.|sd
B|What's the last movie you saw?|qw	A|GHOST.|sd
B|to talking on How does that sound?|qw	A|There you go.|ba
B|and,  what did she do with the,|qw	A|I think she was,|sd
B|Well, Hal, what's, uh, what's crime like in Dallas?|qw	A|Well, it depends where in Dallas you are.|sd
B|What, what do you think can prevent crime?|qw	A|Well, the thing is, I don't,|%
A|What are, what does your city have for gun control if anything?|qw	B|Well, see Maryland is one of the most,|%
B|What part of Michigan were you living in?|qw	A|Oh, I grew up in Dearborn which is a suburb of, of Detroit.|sd
B|What brought you down here?|qw	A|Oh, a teaching job.|sd
A|How would you feel about sending an elderly family member to a nursing home?|qo	B|Well, I don't feel very good about it,|sd
A|And what type of recommendations did you have when you decided where to place him?|qw	B|Um, well, the, see, uh, well,|%
B|Uh, what do you think?|qo	A|My grandmother lived with us, um, until August, um,|sd
B|So what do you use for cookbooks?|qw	A|Um, I have a PILLSBURY cookbook I got when I was married,|sd
A|but, what you serve or what would you|qw	B|Well, I, I, I think we come from, from different backgrounds, uh,|sd
A|What's one of your favorites?|qw	B|Um, gee,|^h
A|Anything else you wanted to add?|qo	B|Well, you had said dinner, you know, you know,|sd
B|What about you?|qo	A|We found this Oriental tile game called Mah-jongg .|sd
A|So what,  So what  gets you?|qo	B|As far as I'm  ,|%
B|Uh, what do you think?|qo	A|Well, I mean I,|%
A|I mean if you could legislate something, what would you legislate?|qw	B|I really don't know.|sd
A|what kind of house do you live in?|qw	B|Well, uh, we live in a, a brick home in far north Dallas|sd
A|I wonder how long it's going to be on for.|qw	B|I think five minutes is the max.|sd
B|Well, what did you have for lunch?|qw	A|Oh, it was, uh, it was,|%
A|If you're having a dinner party, what, what would you serve?|qw	B|Okay, uh,|^h
B|How does that sound?|qw	A|Jeez,|ba
B|and now where are you in New York?|qw	A|Upstate.|sd
A|What is your handicap?|qw	B|Right now it's three.|sd
A|So what do you, uh, think is the, uh, the worst culprit for air pollution?|qw	B|Well, I think it's, it's probably a combination of things.|sv
A|what do you think?|qo	B|Well, I never gave it any thought myself|sd
A|Oh, but, uh, anyway, how did you get on this program?|qw	B|I work at T I.|sd
B|But  how did you get on it?|qw	A|Well, my husband works at T I over on Central.|sd
A|So, how is the weather out there?|qw	B|Uh, it's really cold|sd
B|How about you guys?|qw	A|Um. Uh, it's just, it's a, it's about same.|sd
A|What part?|qw	B|And, uh,|%
B|So, what's the temperature up today over there?|qw	A|Oh, man,|ba
B|What's your major?|qw	A|Uh, it was nursing,|sd
A|In,|qw	B|Uh, elementary and special ed.|sd
A|What changes do you feel have happened?|qw	B|Oh, I guess the first thing has been the, uh, for the right, for women to vote.|sv
A|What do you see, uh, changing in the future?|qw	B|I think that we're probably going to see a lot more companies, uh, run by females.|sv
A|How big is Provo?|qw	B|Um.|%
B|So do you, what do you think is good about the schools?|qw	A|That is good about,|%
B|So what's the conditions like in Dallas?|qw	A|Well, uh, in Dallas, I, I haven't seen air pollution quite on a, quite on a level that we had in Denver.|sd
B|What do you like to do?|qo	A|Um, I try to do some painting, although I'm not very good at it|sd
B|how do you isolate them?|qw	A|You get a|sd
B|Who is the competition going to be?|qw	A|Well, it's supposed to be the Redskins, but you know, we beat them already.|sd
A|How about you guys?|qo	B|We have three dogs and two birds at this point.|sd
A|what kind of birds do you have?|qw	B|Parakeets.|sd
A|Well, what kind of vacations do you like to take? .|qw	B|Well, we've, uh, we've been fortunate enough to take a couple of trips over to Europe|sd
A|Where have you gone there?|qw	B|We've gone to, um, Germany, Switzerland, Austria, Ireland and England.|sd
B|Where have you been?|qw	A|I even.|%
B|How did you like Africa?|qo	A|Well, I liked it.|sd
B|What type of work?|qw	A|Um, I was working with an organization that does Bible translation.|sd
B|where do you go?|qw	A|Uh, I U.|sd
A|Well what do you think can be done about the crime in the city?|qw	B|Well, I think it's, what's been happening over the last several years it seems they've been beefing up the police patrols, trying to put, put more guys, more cops, higher visibility,|sv
A|So how do you know this much about, um, stealing cars?|qw	B|Well, after I found mine I had to, I had this,|sd
A|So, how you like New Jersey?|qo	B|Uh, it's pretty good, you know.|sv
B|How about yourself?|qo	A|Well, I don't know.|no
A|What do you think?|qo	B|Well, uh, I can't be terribly authoritative on what life was like thirty years ago, uh, because I'm not that old yet.|sd
A|What do you do now?|qw	B|Uh, computer programmer|sd
B|Well what else?|qo	A|I believe we've pretty much summed everything up.|sv
B|Where is that?|qw	A|Uh, it's about thirty miles from Sherman.|sd
A|Um, what kind of hobbies do you have?|qw	B|Um, I do a lot of cross-stitching and painting, when I do have spare time.|sd
A|How old?|qw	B|He's seven months old.|sd
B|what's his name, plays the trumpet. Yeah.|qw	A|I like the Moody Blues.|sd
A|where are you?|qw	B|We're in Sherman.|sd
A|What, what do you do?|qw	B|Well, right now I'm just a homemaker,|sd
B|So what, what, how do you spend the time with your children?|qw	A|Well both of mine are boys.|sd
B|What, what are you doing?|qw	A|Baseball has started.|sd
B|And where do you go?|qw	A|Different places every year.|sd
A|What are you learning to be?|qw	B|Oh, oh, excuse me?|br
A|What degree, I mean, what are you wanting to do after you get out of college?|qw	B|Well, I, I'm doing computer science, computer engineering.|sd
B|How do you feel about them, I mean, since you've kind of been close to that.|qo	A|Well, I've Well, I can kind of see both sides, you know,|sd
A|How about yourself?|qo	B|All right.|aa
A|So, do you have any hobbies?|qo	B|Well, right at the present time nothing real special.|sd
B|Now where is this?|qw	A|Uh, it's in Georgia.|sd
A|Do you do anything on a regular basis?|qo	B|Well, off and on,|sd
A|Well, anything else about exercise we can talk about.|qo	B|Well, other than I need to go.|fo_o_fw_"_by_bc
B|Well what are the others?|qo	A|Well, uh, I originally came from Saint Louis,|sd
B|what do you, what do you think of Incaviglia's loss.|qw	A|I kind of think it was necessary,|sv
B|well how do you think the Royals are going to do?|qw	A|I think the Royals will do okay.|sv
B|Well, well when are the Rangers going to come through|qw	A|Uh, that's a good question.|sd
A|what baseball team are you familiar with?|qw	B|Well, I'm only a little bit familiar with the Red Sox because I lived up in Boston for a while,|sd
B|Uh, what do you want to concentrate on.|qw	A|It doesn't matter to me.|sd
B|But, uh, what do you think about the mess that's, we've created in Iraq?|qo	A|I think it's unfortunate, uh, as far as the Kurds are concerned,|sd
B|what kind of time frame is it, uh, looking for the, uh, different shifts up there?|qw	A|I|%
B|So, what was our question about, decline in|qw	A|Wasn't the decline so much.|arp_nd
B|Where do you think it's, where do you think it's going to go in twenty years?|qw	A|I haven't the slightest idea.|sd
B|I'm curious what was your, uh, graduate study in?|qw	A|Well, I, I was in English as a matter of fact, and medieval studies,|sd
A|what do you think are some current trends in, uh, the way families spend time together, based on what you've seen.|qw	B|Um, I, I think that it's getting to where they're not spending time together.|sv
A|If I had kids, well if you had kids, what kind of things do you hope to do? like paper|qo	B|Um, I, I hope to, of course, be able to teach them right from wrong.|sd
A|by, what do you mean by liberal, um.|qw	B|Liberal politically,|sd
A|Uh, what's the main, what's the main difference between Republicans and Democrats?|qw	B|Okay,|bk
B|How old are you?|qw	A|I'm twenty-six.|sd
A|Well what did you think  of Reagan as a president?|qw	B|I just thought he was really inept.|sv
B|What do you do?|qw	A|Uh, I ride a bicycle quite a bit and uh, work out with free weights|sd
A|So what's your motivation?|qw	B|What, what's my motivation?|br
B|Well how old are you?|qw	A|I'm, uh, twenty-seven.|sd
B|what is it?|qw	A|Steroids.|sd
A|What do you think of that, uh, the greenhouse effect that's going on?|qo	B|Well I guess that's the fluorocarbons|sd
A|How long have you been in Raleigh?|qw	B|Um, I've been out of Texas about ten years.|sd
A|Well, how old are you?|qw	B|Oh, twenty, uh, seven.|sd
B|How'd you get involved in this research?|qw	A|Um, I worked at T I for a while,|sd
A|How'd you get into it?|qw	B|Um, I, I was taking a voice I O class and, um, and actually doing some research,|sd
A|Uh, how many kids do you have?|qw	B|Just two,|sd
A|What year, I mean, how old are they?|qw	B|Four and five.|sd
B|When does it, when does it bloom?|qw	A|But I do not much,|%
B|And what color?|qw	A|oh, they come in all different colors.|sd
B|what color is, is yours blooming?|qw	A|I have got some in the backyard that bloomed blue. Which I would not, would have liked those in the front because they match my porch and stuff better. And then some on the side of the house with the dusty purple color. With little purple spots that it, it will fade into a solid purple.|sd
A|How do you spell that?|qw	B|G o m p h r e n a.|sd
A|How do you feel about it?|qo	B|Well, yeah,|aa
B|How often do you meet?|qw	A|Well, we try,|%
A|What are you providing ?|qw	B|and I have to make hors d'oeuvres|sd
A|What was one of the latest ones that you've seen, actually?|qw	B|Oh, I I think we rented PRETTY WOMAN a couple weeks, months ago.|sd
A|What are some others that you have seen lately?|qw	B|Oh, I'm trying to think, uh,|^h
A|what did I say, Peter?|qw	B|I think you said Peter.|sd
A|Who wrote that?|qw	B|Oh, I do not remember the man's name,|sd
A|where have you all been on vacation recently?|qw	B|Recently,|sd
B|What did you wind up with?|qw	A|Oh, I had fondue.|sd
B|So but,  what does you husband do now?|qw	A|Uh, he is an engineer,|sd
B|what is your last name?|qw	A|Kuenzer, K U E N Z E R,|sd
A|Or, or what do you think?|qo	B|Oh, yeah|ny
A|What, what kind of work do you do?|qw	B|I am a drafter.|sd
B|Well, when she got home, who took  care of her?|qw	A|Yeah.|b
A|How do you feel about that Lenore ?|qo	B|I am very much for capital punishment.|sd
A|Uh, what, uh, what activities do you do when you're camping?|qw	B|Oh, we take little nature hikes|sd
A|What type of things do you feel would invade your privacy every day?|qw	B|Um, huh. Well, I don't like it when, uh, people listen to my phone conversations, like if they're outside my door while I'm talking in my room or when people like look through my things in my bedroom|sd
A|Now what can you do to stop that?|qw	B|Oh, I don't know.|sd
A|Let's see. What else is an invasion?|qw	B|I had an old boyfriend who looked through my notes one time|sd
B|And what did you graduate in?|qw	A|I|%
A|in what major or what year?|qw	B|Yeah,|b
A|How long of a program is that?|qw	B|Forever|sd
B|So what is your advice to picking a college.|qw	A|My advice is is, uh, look for, at the student to faculty ratio, you know,|sd
B|Is that, what was yours more like?|qw	A|Yeah|b
A|Well, what would be your advice to a parent of a child thinking of attending college?|qw	B|Oh, man. I think your advice is good.|^h
A|What do you think has caused our horrible situation?|qw	B|Uh, I don't think there's any one simple answer to the whole thing.|sv
B|So which one are we going to throw out?|qw	A|Well, I hate to say it,|sd
A|How did you get on this T I thing?|qw	B|Oh, I, I know some of the people.|sd
B|What, what, what sort of, of regiment do you have?|qw	A|Well, I just got back from biking twelve and a half miles,|sd
B|What, what, what, what's on, what's this mat, I mean,|qw	A|It, it, it's just an exercise mat that rolls up|sd
A|what do you think about, uh, the self insurance business?|qw	B|Well, I watched something on T V a couple of months ago by, uh, General, ex, uh, Surgeon General Koop.|sd
A|Uh, how about yourself.|qo	B|Um, well, I'm certainly in favor of AIDS research,|sd
B|Whose figure is that?|qw	A|I don't know.|sd
A|What do you think, Doug, of Mister Johnson?|qw	B|Um well, I, well, I am sorry that he has the virus.|sd
B|Where are you from originally?|qw	A|I'm from, uh, northern Utah,|sd
B|What  kind of woodworking  do you do?|qw	A|Do you, uh,|qy
A|How about yourself?|qo	B|Uh, well, I like to think of it as a hobby, but I, I guess also, partly out of necessity. Just repairing things around the house.|sd
A|How about yourself?|qo	B|Well, we, uh, left here in seventy-six.|sd
B|So.  What kind of business are you in?|qw	A|I'm in the, uh, sporting goods business.|sd
A|What, who are you with?|qw	B|Uh, we're with an organization called, uh, Wycliff Bible Translators.|sd
A|How did that compare with this area as far as housing prices?|qw	B|Uh, we were, uh, really surprised to find that they're higher here.  Uh,|sd
A|Um, what's your situation?|qw	B|I work for the University of New Hampshire,|sd
A|What do you consider most important, you think, in terms of, of the different benefits?|qw	B|Well, I think, uh, the, the health care, of course, is an important, and has to be the single most important benefit|sv
A|how, how does, uh, University of New Hampshire handle it?|qw	B|Well, we have two different plans that we can subscribe to under dental, uh, depending,|sd
A|What's your view.|qw	B|Huh?|br
A|What's your view?|qw	B|Well, I have a hard time thinking that they can control guns. Personally.|sv
A|What do you do, Jeff?|qw	B|Uh, I, I'm in, uh, program control for a company up here.|sd
B|What do you do?|qw	A|I'm, uh, researcher of Honeywell up here.|sd
B|How is the weather up there?|qw	A|Oh, it's not too good.|sd
A|well, what year are you in in college?|qw	B|I'm a sophomore.|sd
B|What did you major in?|qw	A|I majored in business administration.|sd
A|Where?|qw	B|In Arizona.|sd
A|Uh, what kind of books do you enjoy reading?|qw	B|Uh, haven't, have, I have a wide variety of, of hobbies,|^h
B|How about yourself?|qo	A|Well, um, I have an interest in art,|sd
A|How about you?|qo	B|Um, well I hate to,|h
A|what would you have, who, who, who would determine what these people do.|qw	B|Yeah,|b
B|How about in your case?|qo	A|Well, in my case my husband is not a carpenter,|sd
A|How do you feel about that.|qo	B|I don't really,|%
B|Well, how did you get a recipe for pudding on your own?|qw	A|Um, actually I found it in one of my mother's, um, homemade cookbooks,|sd
B|If you were, uh, what do you think about the whole concept of a trial by your peers?|qo	A|Well, I think it's a good idea.|sv
A|Well, how many credit cards do you have?|qw	B|Um, I've only, I've got about four maybe.|sd
A|Uh, what do you think about the idea of providing one for somebody like that?|qo	B|Um, well,|arp_nd
A|So what kind of weather have you had in Dallas?|qw	B|Well, it's been very windy,|sv
B|What's, what's her name?|qw	A|Ann Richards.|sd
A|Well, how do you feel about, uh, drug testing?|qo	B|Um, personally, I don't have a problem with it, uh,|sd
A|Well, what's your views on it?|qo	B|I think it's, uh, a good idea.|sv
A|First,  let me ask  you, what's, what's the weather like up there to begin with?|qw	B|And good,|%
A|What did you like to do most?|qw	B|Well really just commune with nature.|sd
A|Where did you live?|qw	B|A little town called Tuckaho, over by White Plains.|sd
A|how do you feel about them?|qo	B|Well, I keep trying to get away from them,|sd
B|What about you?|qo	A|Well, we have this philosophy, we use it when we go off somewhere|sd
A|What are they?|qw	B|well I don't know if they consider themselves animals anymore.|sd
B|How did he do that?|qw	A|well we put some papers on the floor, underneath the john|sd
A|Well, what do your cats do besides sitting and purring and letting you pet them|qw	B|Oh, my goodness, these guys, they, well actually they're my husband's pets.|^h
B|What do you read?|qw	A|Oh, uh, well, I read for a living.|sd
B|What kind of books?|qw	A|Center for Advanced Study of the Behavioral Sciences and therefore, I read, uh, psychology, sociology, anthropology, political science, philosophy, linguistics, history, uh,|sd
A|What do you think is, the most promising, or practical book, uh, of that kind you've read recently?|qw	B|Um, Oh, I I have a love affair with John Bradshaw.|^h
A|I mean, what thoughts do you have on the subject?|qo	B|Uh, you know, we even lived there for a, a while when my husband was in the Navy.|sd
A|Where does he work if you  don't mind me,|qw	B|He,  he works for Bramalea Company,|sd
A|What's the name of that company|qw	B|Bramalea.|sd
A|What do they do?|qw	B|It's a security company|sd
A|How is T I in that mode?|qw	B|Well, very well, um,|sv
A|Well   well, who, who else  is going to do this, then?|qw	B|Do they  wind up with more red tape, and  more problems then?|qh
B|How about you?|qo	A|Yeah,|^h
A|Where have you been on a wonderful vacation?|qw	B|Well normally when we go on vacation we go home, to Colorado.|sd
A|Well, what kind of things do you like to do when you go to Colorado?|qo	B|Oh, well, we like to ski, of course,|sd
B|what state are you in?|qw	A|Texas.|sd
A|What's your favorite thing to cook if you're having a dinner party?|qw	B|Um, I have a great recipe for sour cream chicken enchiladas|sd
B|What about you?|qo	A|I end up with an old stand-by that we call Russian chicken, because it's so easy|sd
B|Well, what do you put in it?|qw	A|Uh, you make, you just take your boneless chicken breasts|sd
A|Um, what, what kind of experience did you have?|qo	B|Well, I, uh,|%
A|What is twenty-one thousand?|qw	B|Pardon?|br
A|What school is that?|qw	B|It's Southwest Missouri State University|sd
A|who do you like?|qw	B|Okay,|b
A|and who's the other big guy?|qw	B|Well, in Oklahoma we say Garth Brooks|sd
A|What do you teach, what grade?|qw	B|Well, it's ninth, nine through twelve|sd
A|and how do people feel about it?|qo	B|So, we're familiar with it.|sd
A|What is your favorite show?|qw	B|Well, I was just trying to think.|^h
B|What do you watch?|qw	A|I watch just about anything,  but  not a lot of,  T V.|sd
A|So, so what have you seen lately that, um, you think is worthwhile?|qw	B|Um, the last movie I saw was REGARDING HENRY.|sd
B|Uh, what is the topic?|qw	A|The topic is cars.|sd
B|Well, where do you think they are heading this year?|qo	A|Uh, it's hard to say.|sv
A|What's going on?|qw	B|Well, just go ahead and talk,|sd
B|What does he charge me?|qw	A|Well, my,|%
A|What do I do with it?|qw	B|I know,|sd
B|So, how's the baby, do you think|qo	A|What?|br
B|How's the,|qw	A|We could talk, Let's talk about the baby.|oo_co_cc
A|What kind of consulting do you do?|qw	B|Uh, systems consulting. Computerization for construction firms.|sd
A|what kind of dinner parties have you had?|qw	B|Well, I've had them, uh, where I've served up to twelve to sixteen people.|sd
A|Well what do you think about the everyday occurrences that are, that are an invasion of your privacy?|qo	B|Well, the, uh,|%
A|What, what do you, where are you from?|qw	B|Oh, I'm from Texas.|sd
B|what part?|qw	A|Yeah,|b
A|What kind of dining out do you like?|qw	B|Well, there is two kinds.|sd
B|What about you?|qo	A|We have  one called Chi Chi's in in our area.|sd
A|Where did you go to college?|qw	B|Uh, I went to the Naval Academy.|sd
B|What area?|qw	A|Underwater acoustics.|sd
B|when did you retire?|qw	A|The end of last month.|sd
A|How  do you like Chinese food?|qw	B|Oh, we, we do enjoy that.|sd
B|But do you,  What about you?|qo	A|Uh-huh.|b
B|Um. Where did you learn how to do Chinese cooking?|qw	A|Uh, just at home.|sd
B|What's a good reference cookbook for Chinese food?|qw	A|Okay,|b
A|What  do you think about these things?|qo	B|Well, as I look at our trial systems,|sd
B|How do you feel about that?|qo	A|I have been in a fairly important trial,|sd
B|What if they used law students and had that be credit hours to sit in trials?|qw	A|That would be certainly nice|sv
A|Uh, what, uh, possessed you to get the dog?|qw	B|Well, I guess, in one sense we felt that, it, it's nice to have a dog even though there are, you know, complications come with it.|sv
A|How do you get your news mostly?|qw	B|Generally, I get most of my news from, uh, the radio.|sd
B|How about you?|qo	A|Well, I can hardly wait for my morning paper to come.|sd
B|So, what sort of car are you interested in getting next?|qw	A|Well, actually, I love the car I have.|sd
B|how long does it take to go back up? About the  same time.|qw	A|Twenty seconds,|sd
B|Um, where do you stand, uh, on,|qo	A|Well, I think that people should be allowed to have them.|sv
B|Where does your friend go to to recycle?|qw	A|She lives in Garland|sd
A|What?|qw	B|We could prohibit people from being hired that are historically going to cost the company money. You know, do a little bit better research on who gets hired|sd
A|What did you get your degree at?|qw	B|Industrial Marketing.|sd
A|And what's your job now?|qw	B|Well, actually I'm selling computer software.|sd
A|what would you say?|qw	B|Well, I'd encourage it.|sd
A|how do you feel that is for someone at, at that phase in their life?|qw	B|Well, the for some people, it's good because they maybe they need a little discipline, need a little reining in at that, that stage in their life.|sv
A|what kind of fishing do you enjoy?|qw	B|Well, uh, normally I like to, to go out fishing in a boat, and, uh, rather than like bank fishing, and just like to try and catch anything that's swimming, because I've had such problems with trying to catch any type of fish, that, uh, I just really enjoy doing the boat type fishing.|sd
A|What area of lakes do you like?|qw	B|Well, uh, now, I haven't done much fishing here in Texas, uh, because I moved from Ohio,|^h
A|What's the largest fish you ever caught?|qw	B|Uh, gosh,|ba
B|What are your feelings on it?|qo	A|Well, um, I, I think that we probably are paying a little too much tax considering what we're getting for it and how it's being managed and so forth.|sv
B|And what are you going to buy?|qw	A|I I don't know,|sd
A|how do you like that|qo	B|Well, have you been listening to Iacocca's arguments that, uh, that Chrysler products are the only ones that, that all have air bags?|qy
B|What, what kind was it?|qw	A|that's it.|fo_o_fw_"_by_bc
B|then, so like your pay, what kind of a percentage do you basically keep out that you think that, you know, will cover all of the expenses, kind of thing?|qw	A|Well, in.|%
B|Or like what, what percent, do you then save or something?|qo	A|Uh, we have a lot of different things.|sd
B|Where are you from?|qw	A|Lubbock.|sd
A|What division you all in?|qw	B|I'm sorry, what?|br
A|What division are you all in?|qw	B|We're both, uh,|sd
A|where are you from?|qw	B|This is Baltimore, Maryland.|sd
B|What are you interested in in restaurants?|qw	A|Right, uh.|b
A|Well, what type of restaurant do you like, Richard?|qw	B|Uh, really, I'm kind of open on food.|sd
A|What do you look for in a restaurant?|qw	B|I hate franchised restaurants.|sd
A|out of, which direction?|qw	B|Colorado Springs.|sd
A|Out of, which direction from there?|qw	B|West|sd
A|What are your favorite programs?|qw	B|Uh, it's kind of hard to put my finger on a, on a favorite T V program,|sd
B|What building do you work in?|qw	A|I'm in the South Building.|sd
A|how many calls have you made?|qw	B|I've only made a few.|sd
A|what did you buy?|qw	B|A Ford Explorer.|sd
B|And why would that be?|qw	A|I don't know, I,|no
B|What's wrong with the Volvo.|qw	A|Oh, I don't know, they're, they're not as nice looking.|sv
B|What, what city are you calling from?|qw	A|Sherman.|sd
A|Where are you?|qw	B|Up in Dallas.|sd
B|What do you presently drive?|qw	A|Uh, Mercury Topaz.|sd
B|what are your feelings about American versus European cars?|qo	A|Um, I like anything besides Japanese.|sd
B|Why not.|qw	A|But, uh, European, I don't have any, I mean,|sd
A|And what religious faith?|qw	B|Uh, Latter Day Saints.|sd
A|What part of the country are you in?|qw	B|Oh, boy, this is going to be tough, I'm in Plano|sd
B|what part of Dallas are you from?|qw	A|Far north Dallas|sd
B|How does it compare to the years past?|qw	A|um, I don't know, I haven't lived here, let's see, we lived out of state in Wisconsin|sd
B|Well, what brought you guys down to Texas then?|qw	A|Uh, his job, he came back to start work again for a different company,|sd
A|Where did you move here from?|qw	B|Colorado.|sd
A|what kind of things do you like to do in your spare time?|qw	B|Well, uh, I have two children,|sd
B|How about you?|qo	A|Oh, I, uh, like sports type things too.|sd
B|How about you?|qo	A|Yeah,|ny
A|Really, where did you come from?|qw	B|Um, well, Ohio, kind of.|sd
B|Well how did you do?|qw	A|I won a dollar|sd
B|So how old is your retriever?|qw	A|Oh, she's about four.|sd
B|What's wrong with that?|qw	A|I don't see a thing wrong with that.|sd
A|Where you from?|qw	B|Georgia.|sd
B|If you had to pick one, what would you choose?|qw	A|Uh, I would probably go with,|sd
A|Uh, uh, how about the Oak Ridge Boys.|qo	B|Very much so.|na
B|How many children do you have?|qw	A|I have four.|sd
A|How many do you have?|qw	B|Well, I have two children and, uh, two stepdaughters.|sd
B|How old is your granddaughter?|qw	A|She's three.|sd
B|What is the best advice of mothering that you know?|qw	A|The best of, Well, uh, Cathy, I think if you look to the Word of God and, uh, think on the things that are pure and lovely|sv
A|Uh, and how, how do you feel about, uh, let's see, eye care?|qo	B|Eye care is good.|sv
A|And how do you feel about murders of law officers or fire people or something that are,  because they have had them, they have had them killed when they have,|qo	B|Well, what bothers me,|sd
A|What do you think?|qo	B|Well, I think that's a big part of it|sv
B|What about you?|qo	A|Well, I've worked all the time up until just about a year ago.|sd
B|So, where do you see,  us changing in the future?|qw	A|I don't.|sd
A|Uh, how do you feel about the death penalty?|qo	B|Well, I, you know,|%
B|When was the last time you went?|qw	A|The last time I went camping was about, uh, in the middle of October,|sd
A|How about yourself?|qo	B|Well, I haven't been in probably about three years.|sd
A|What do you think, what kind of  camping, uh, are you talking about?|qw	B|Do you do a lot of fishing?|qy
B|What do you have?|qw	A|We have a tent.|sd
B|what did you normally do?|qw	A|We normally, yeah,|sd
A|What do you like to do when you go camping?|qw	B|Um, well, let's see. I just, I mean, I just like to go|sd
B|How big a family do you have?|qw	A|Um, well, it wasn't that big of a family,|sd
A|What are your favorite T V shows?|qw	B|Uh, I guess one of my favorite ones is CHEERS.|sd
A|Oh, so what would be the, your favorite meal to cook?|qw	B|None to cook.|sd
B|So what about yours?|qo	A|Well, my wife and I and we've got a thirteen week old baby|sd
A|How do you usually cook your deer?|qw	B|Huh?|br
A|How do you usually cook your deer?|qw	B|How do we usually?|br
B|Or where are you from?|qw	A|No.|fo_o_fw_"_by_bc
A|What do you think as far as air pollution in the Dallas area?|qo	B|Well, I have some small experience in this area.|sd
A|Who are you with?|qw	B|I own an insurance agency, a managing general, a wholesaler of insurance, uh out in Addison|sd
B|How about you?|qo	A|Well, I'm into it. Uh,|na
A|What, what,  what are green fees run there?|qw	B|Uh, well they range anywhere from about five bucks for your basic city type course up to fifty, sixty dollars for a really, really nice course.|sd
A|What do you do for a living?|qw	B|Uh, I'm a student right now.|sd
A|Which, uh, which university?|qw	B|At, uh, Indiana University.|sd
A|What are you going into?|qw	B|Uh, I don't really know.|sd
A|what was  what was that movie that they had out?|qw	B|Yeah.|b
A|Or what do they do with you guys if, that you guys get,|qw	B|Uh, we get counseling|sd
A|What about you|qo	B|Well, let's see.|^h
A|What do you think about these items that are going to be, uh, taxed even more. Like, uh, tobacco and that kind of thing|qo	B|I think in a, in a way it's good, in a way it's not.|sv
A|how old is your car?|qw	B|Uh, well I have a, I have a nineteen eighty, uh, eighty-five C R X.|sd
A|So what do the Miatas run?|qw	B|they're about, uh, uh, thirteen to fourteen thousand dollars and, you know, a bit more if you add some some options  and so on|sd
B|What are you interested in?|qw	A|Whatever my husband buys|sd
A|In what way are you talking about.|qw	B|Well, I like the idea of volunteer, voluntary support.|sd
A|what, what year are they looking at?|qw	B|Well, they're not.|arp_nd
A|Uh, what age group are, are they looking at?|qw	B|Uh, oh eighteen.|sd
A|So, you, you've only known the dog, how long did you say.|qw	B|Well, about a year I guess.|sd
A|uh, uh, how old is the dog?|qw	B|It just turned two, I believe.|sd
B|How, about how big then?|qw	A|Oh, she weighs in at about fifty pounds,|sd
A|What's her name by the way?|qw	B|Uh, pardon?|br
A|What, what do you call the dog?|qw	B|Oh, it's, uh, Mitzi.|sd
A|How's that?|qw	B|Okay,|aa
B|What is that?|qw	A|I want to say Oklahoma,|sd
A|Uh, what are your feelings?|qo	B|Well if I,|%
A|Ellen what kind of a car do you think you're going to buy? and background|qw	B|Well, as a matter of fact, I was thinking about that the other day,|sd
A|but what about, um, their reputation of the company or the price.|qw	B|Yeah,|b
B|how about you?|qo	A|Well, um, the last car we bought was American because of, because of that reason,|sd
A|or like what things are you looking at?|qw	B|Well, I haven't really gotten that far with it, um,|sd
A|where are you from?|qw	B|Uh, Virginia.|sd
A|What have your other topics been?|qw	B|the other topic was, like I said, uh, something about politicians.|sd
A|well how did you get into this program.|qw	B|Excuse me. How did I get into it, oh,|b
A|So what do you think we're going to get?|qw	B|What do you think,|br
A|What do you think we're going to get for this?|qw	B|Get.|br
B|But anyhow, um, what have you seen?|qw	A|Well, last week, as a matter of fact, my children was on Spring Break|sd
B|Well, how bad were the side effects?|qw	A|Bad.|sd
B|Well how about KINDERGARTEN COP?|qo	A|Oh, yeah|b
B|Where do we get that from?|qw	A|Yes,|fo_o_fw_"_by_bc
A|So what are you going to get it off with if you get it on and it's dried?|qw	B|Well, it's, it's not too bad.|sd
A|So where do you live?|qw	B|Uh, live in Dallas.|sd
A|What do you think about, uh, the way the criminal justice system handles trials?|qo	B|Well, you know, they tell you that you get tried by a jury of your peers|sd
A|Now what are they supposed to do?|qw	B|They turn them loose.|sd
B|When is the time you had fifteen thousand dollars all at one time to go out and buy an automobile?|qw	A|But, see, we made poor choices in college.|sd
A|What?|qw	B|Very simple.|sd
B|How do you feel about that?|qo	A|I don't, I don't feel we should loan them money.|sv
A|or  I mean, what do you think long term?|qw	B|Well, I don't believe in a single  government or a single control for the world.|sd
A|How about yourself?|qo	B|Yeah.|b
A|what types of music do you like to listen to?|qw	B|Well, I primarily listen to classical music when I have my druthers, partly because I find it more soothing.|sd
B|How about you?|qo	A|I like classical music also.|sd
A|where do you live?|qw	B|Uh, I live in the, uh, Washington, D C area, Maryland.|sd
A|What?|qw	B|Because I have always played classical music, uh, or classical style,|sd
A|Uh, how is that going to affect the, uh, sports weapons? I mean, rifles, that are automatic or semiautomatic?|qw	B|Uh-huh.|b
B|and what do, do you think about it?|qo	A|Well, I think it's a very, very complicated,|sv
B|Well, what did you do when you helped these people?|qw	A|Well,|%
B|How did you, what did you do,|qw	A|I, I wasn't helping them.|sd
A|what is the woman's name whose, us, not the mayor but the, *typo should be who's|qw	B|The manager.|^2
B|And how big is it?|qw	A|Which  is still kind of expensive|sv
B|well what's included in that?|qw	A|You mean in a one bedroom?|br
B|Which one is it?|qw	A|It's Wood, uh,|sd
B|Where is|qw	A|right next to  Village Green,|sd
B|Where?|qw	A|I'm  a, I'm a news reporter.|sd
A|How often do you all come through Waco?|qw	B|Oh, every now and then,|sd
A|Why?|qw	B|I,|%
A|Uh, where is your family from?|qw	B|Uh, Missouri.|sd
A|So, how long did you say it has been since you all had one?|qw	B|I do not know.|no
A|But if you were going to a restaurant, say, um, where would you go?|qw	B|Oh, well we had, uh, we have a lot of favorites here, uh, in Northern Virginia|sd
B|what is,|qw	A|We do not watch a lot of T V,|sd
A|What kind of singing do you like to do?|qw	B|Oh, pretty much anything.|sd
A|Whereabouts?|qw	B|In, uh, in Germany.|sd
A|So, whereabouts in, Texas are you, if I could ask?|qw	B|Oh, I'm in Flower Mound.|sd
B|Why, why did you check music?|qw	A|Why did I pick music?|br
B|What kind of music do you enjoy?|qw	A|Um, I really enjoy the oldies,|sd
B|Like what, what kind of oldies?|qw	A|Uh,|%
B|Which album, which of his albums do you think is the best?|qw	A|Oh, I don't know.|no
A|I mean, what can we do,|qw	B|Oh, yeah,|b
A|So, Beverly, what do you think about drug testing?|qo	B|I think in some professions it's, uh, essential. Things like pilots and things that involve the safety of other people particularly.|sv
A|So, what kind of a house do you live in?|qw	B|I'm in a, uh, in a ranch.|sd
B|How many square feet do you have?|qw	A|We have got about, uh, twenty, I'd say about twenty-four hundred.|sd
B|How are they built?|qw	A|Um, we've been real happy with it.|sd
B|How long have you been in it?|qw	A|Seventeen years.|sd
A|Uh, how about yourself?|qo	B|Well, I'm like you.|sd
B|What, what brought about the fading of the paint?|qw	A|Well|%
B|Did you go, what kind of paint did you use on the ceiling?|qw	A|We used a flat, latex paint|sd
A|where does she live?|qw	B|Uh, on Rutherford.|sd
A|What about you?|qo	B|I,  I don't think under the way the system is right now, it is.|sv
A|What were they doing  taking some,|qw	B|Oh, they were  taking kickbacks.|sd
A|How about you?|qo	B|Well, my graduate work is in speech pathology,|sd
A|What kind?|qw	B|Uh, its an Emerson eighty eighty-six, um, two low density floppy drives, and no hard drive yet.|sd
B|Which,|qw	A|Computers.|sd
A|What do you think of that fuzzy logic?|qo	B|I've not had a chance to work with it, although, um, my, uh, data structures teacher was telling us something about how fuzzy logic works as far as the concept behind it.|sd
A|Uh, well, where in Dallas are you?|qw	B|I'm in Richardson.|sd
B|What about you?|qo	A|Well, I'm, I'm in Dallas proper in the city of Dallas|sd
B|Where do you take them?|qw	A|Well, there's, there's a couple places.|sd
A|Where is that?|qw	B|Uh, she's not here anymore|sd
A|What in the world do you do with your computer that takes so much time?|qw	B|Well, I sit and design cards|sd
B|but. What hobbies do you have?|qw	A|Well, I, uh, play trombone in the Plano Community Band.|sd
B|How big is your band?|qw	A|Well, we got, uh, pretty good size band.|sd
A|Well what is this going to do the insurance companies who are supporting this work now and hopefully are doing, uh, a good job?|qw	B|Well, it's going to make it tough for them|sv
B|When is your good watching time?|qw	A|Uh, it seems like ten o'clock at night|sd
A|How long was that?|qw	B|I forget.|sd
A|And, when was this.|qw	B|Uh, I graduated in eighty-six.|sd
B|What type of camping did you do?|qw	A|Well when we, before we had kids, we was in a motorcycle group, you know,|sd
A|Well, how old is your boys, your children?|qw	B|Well, I, well, I have, um, a son that's, uh, going to be eleven here pretty soon, and then a daughter that's thirteen.|sd
B|What kind is it?|qw	A|A Keeshonden.|sd
B|So, how does she feel about going out and doing stuff with you all.|qw	A|Uh, well it varies what it is, of course,|sd
A|how, how would you spend time with kids?|qw	B|Probably doing outdoorsie stuff, and keeping, trying to keep them away from the T V, I guess And, McDonald's|sd
B|So, uh, what do you think?|qo	A|I think we're overtaxed to the hilt.|sv
A|where, where you at?|qw	B|We're outside of, uh, Washington in Maryland.|sd
B|How about you?|qo	A|Oh, okay,|bk
A|Well how large is Williams?|qw	B|Williams is an undergraduate school only|sd
B|What do you think about, what do you think about the, the lower grades, you know,  K through seven?|qo	A|Well, I, I, I  should imagine the lower grades,|sd
B|what were what were you saying?|qw	A|Well, if you teach uh, college,|sd
B|What about you?|qo	A|Well, no,|nn
B|What,  Well, what kind  what kind of trees are they?|qw	A|and  then it  it, um|sd
A|What about you?|qo	B|Um, I used to have a ton of gas credit cards,|sd
B|What's inside the jelly bean?|qw	A|Uh, it's just, uh, it's just the, the same,|sd
A|What do you have?|qw	B|Well, it's kind of a mixed breed that we got from the Humane Society|sd
A|Uh, which ones have you seen lately?|qw	B|Oh, I just sort of blanking tonight.|sd
A|Which, which Billy Crystal movie?|qw	B|Oh, this is the,|sd
B|What, what kind of movies in general do you like to watch?|qw	A|Uh, well, I like to be entertained once in a while|sd
B|or who do you like after the Mavericks?|qw	A|Oh, gosh,|ba
B|who do they need to trade?|qw	A|Well, I don't know.|no
A|So what are your feelings on the topic today as far as crime in America today?|qo	B|Well, I think some of the blame can be placed on plea bargaining and people getting less time and not serving any of the, or a lot less of the, time than they're given by the court system,|sv
A|our topic today?|qw	B|Uh, yeah,|b
B|What school system does she teach in?|qw	A|Plano School System.|sd
A|What do you think has occurred there?|qw	B|Well, I think one of the major changes is the whole attitude towards women in the work place and the role of women in doing jobs outside of the home.|sv
A|Well, how do you feel about women in, uh, armed services?|qw	B|Well, I think they ought to have the right.|sv
A|so what do you think of the Giants?|qo	B|Uh, I like the Giants.|sd
A|So what do you think is going to happen this year to the teams?|qw	B|Uh, I don't know, it's hard to say.|h
B|How about yourself?|qo	A|Well, uh, we're kind of lucky.|sd
A|So  what kind do you, uh, get?|qw	B|Well I have a bunch of computer journals because I'm in computer science|sd
B|What is your situation?|qo	A|Well, I'm, I guess I don't have such close experience with, with, um, an area becoming a state as you do.|sd
A|So what are your opinions on it?|qw	B|Well, let me preface it.|^h
A|so when did it end?|qw	B|Well, December seventy-two, was when we bombed North Vietnam, and then they released the prisoners in early seventy-three, in that, in that time frame.|sd
B|Well, what's your perspective on it?|qw	A|familiar with it than,|sd
A|but, uh, so what are the Mets going to do this year without Strawberry?|qw	B|Well, I don't know. Um, there's, there's a part of me that says that, you know, um, I'm sort of glad Strawberry went away.|h
A|where, where is Cornell University.|qw	B|Oh, Cornell is in Ithaca.|sd
A|how far is it across the lake to Canada?|qw	B|Toronto.|fo_o_fw_"_by_bc
A|Well, what kind of weather are you having right now?|qw	B|Uh, right now we're actually having, uh,|sd
A|What about you?|qo	B|Well, um, I, uh, exercise regularly.|sd
B|but where did you grow up in California?|qw	A|In Santa Barbara.|sd
A|what kind of books do you like to read, for enjoyment?|qw	B|Uh, mainly, the, the books I read are, uh, business related, or self improvement.|sd
A|What kind of business is it?|qw	B|Um, I've got a, uh, small distributorship, uh.|sd
A|What's the name of it again?|qw	B|Um, LIFE EXTENSIONS.|sd
A|Uh, what kind of house do you live in?|qw	B|Uh, we live in a one story, just like a style home, you know, the standard Texas, uh, Fox and Jacobs.|sd
A|How long have you been in this house?|qw	B|We've been in here ten years.|sd
A|How was it|qw	B|My home town.|sd
A|how were the house prices up there?|qw	B|The prices, actually, a lot better, because Pittsburgh is about the size, I've been trying to think, like a Louisville, or Minneapolis, that type of size.|sd
A|how do you manage both of those?|qw	B|Uh, how do we take care of the house.|^h
B|And how'd that go?|qo	A|the building process was a lot of fun|sd
B|How is, how is apartment dwelling living in terms of general privacy and noise and things like that?|qw	A|It's not as bad as I thought it was|sd
A|so, uh, what are your favorite T V shows?|qw	B|One that I can't find anymore which is GABRIEL'S FIRE.|sd
A|When was that on?|qw	B|It was usually on, um, Thursday nights.|sd
B|What's your second favorite?|qw	A|Um, it's hard to say|^h
A|Where are you?|qw	B|I'm in Dallas, Texas.|sd
A|When is yours on?|qw	B|Ten,|sd
A|So, Jan, how do they recycle in Texas?|qw	B|Well, I,|%
B|But how come we weren't doing this, say, twenty years ago  you  know?|qw	A|Yeah.|b
B|Where did you go on your last vacation?|qw	A|Uh, the last was back down to Lubbock to visit parents.|sd
B|where do you like to go?|qw	A|Uh, we enjoyed Yellow Stone real well last year.|sd
B|What kind of, uh, vacation spots are there in Colorado?|qw	A|Oh, Rocky Mountain National Park.|sd
B|So what are some good things in Texas to go visit?|qw	A|Oh, Galveston.|sd
B|What's there to see in Austin?|qw	A|Oh, U T is real pretty.|sd
B|Um, what did you do when you did exercise regularly?|qw	A|Well, I had, uh, a little routine that I did for warm ups.|sd
B|And what's the name of this book again?|qw	A|CORONARY, CHOLESTEROL AND CHLORINE.|sd
A|what are you making?|qw	B|Um, I, um, I'm making, some, uh,|sd
B|What other kinds of, uh, dinner parties do you serve?|qw	A|Um, well, I don't entertain that often,|sd
B|So anything else you cook|qo	A|Um, I just kind of, you know cook here cook there|sd
A|Well, what kind of music did you all listen to?|qw	B|Oh, my goodness.|^h
A|What was,|qw	B|Woodstock?|^2
B|And, and how does your husband respond to all the new, social, uh, changes?|qw	A|My husband is not a conformist at all.|sd
A|well, what's your opinion about capital punishment?|qw	B|Well, Cathy, I think that, uh, capital punishment certainly has a place in our society, um, maybe from the sense that there are some things that we just can't afford to have repeated, even in the remote chance of repetition.|sv
B|First how much television watching do you do?|qw	A|I do a little bit more than I think usual people do because I am here alone during the day,|sd
A|Um, what about you?|qo	B|Well, actually, I work full time|^h
A|How old are your kids?|qw	B|like ice against a glass, then drinking Mine are grown,|sd
A|Where about?|qw	B|Detroit,|sd
A|What about you?|qo	B|Oh, goodness,|^h
B|Uh, what are your favorite children's books?|qw	A|Oh, there are a couple of Newberry Award winners.|sd
B|What's the best part about it to, to you, the, the quiet, the getting away?|qw	A|Right,|na
A|What is it?|qw	B|Uh, well, I would like for one time in my life to have a convertible.|sd
A|What's, what, what's, what is your favorite, uh, recipes, uh, that you would like to have for a dinner party?|qw	B|Um,|b
A|So, uh, how would you improve upon that?|qo	B|Oh, improve upon that?|b^m
A|How do you cook your green beans?|qw	B|My green beans?|b^m
A|uh, golly. What's this white powder that, that, uh, that you mix with water and gives a thick sauce?|qw	B|A white powder.|b^m
A|But I don't know what do you think some of the long term repercussions might be?|qo	B|Oh, well, you know, I just see this Middle East situation with, with Russia and everything there that's happened I think that that crisis has kind of slowed down,|sv
A|What is the favorite thing you do with your children?|qw	B|Uh, the, the thing that we like to do the most is to watch T V together.|sd
B|and how do you go about it?|qw	A|Well, I have a town home,|sd
B|So how much room do you have?|qw	A|Um, we have virtually no room out in front,|sd
A|What's a good apple to bake pies with?|qw	B|I use my Golden Delicious,|sd
A|Where are you from?|qw	B|I'm from New York.|sd
B|When did you live there?|qw	A|Uh, in the sixties.|sd
A|What kind of books do you like best?|qw	B|Well, I alternate between Danielle Steele is one of my very favorites|sd
B|What do you read?|qw	A|Well, uh, I'm a Tom Clancy fan.|sd
A|What, what time is it there, ten thirty?|qw	B|Uh-huh.|b
A|How about yourself?|qo	B|Well, uh, since, uh,|%
B|What's the topic?|qw	A|Okay,|b
A|Well, Nancy, what do you think, um, some of the changes in roles of women are in American society in the past generation or two?|qw	B|Well, of course, working.|sd
B|Well, what do you think it is?|qw	A|Um, yeah,|aa
A|Well what do you think have been the most significant changes in the past generation or so?|qw	B|Well, just that.|sd
B|Well, what is the most, uh, you know the nicest island?|qw	A|Uh, I like Maui.|sd
A|And then, uh, where, where have you been?|qw	B|Well, I have been to California.|sd
A|How long ago?|qw	B|Oh, uh, eighty-six.|sd
A|who do you work with at this time?|qw	B|Well, I own the company.|sd
A|what do you think are the most important benefits for those working for you, other than, other than their present salary?|qw	B|Um, I'd say in today's economy, besides basic benefits, uh, such as, um, health insurance and life insurance and the, some type of retirement plan I'd say that, uh, most of the employees, uh, um, that we have really like a, a profit sharing plan.|sv
A|How many, uh.|qw	B|You said you retired,|qy^d
A|Well, what, what changes would you, have you considered, uh, in doing it, to, to your company, that might benefit the employees or perhaps the company itself better?|qw	B|Well, um, we, considering instead of tying a profit sharing plan to a, a salary is, uh, is tie, um, uh, a percentage, um of business that, uh, that a person would participate and bring into the company.|sd
A|To?|qw	B|Uh, Orlando, Florida.|sd
A|What is the prognosis for, uh, this year?|qw	B|Uh, real good as far as I can tell.|sd
A|What's most important to you?|qw	B|Well, as far as tangible benefits go I would say that, uh, health insurance of all forms is probably my next most important concern.|sv
A|what company do you work for?|qw	B|Uh, I work for a little start-up company here in Pittsburgh called Trans Ark.  Uh,|sd
B|Uh, what about you?|qo	A|Well, yeah,|ny
B|How about yourself?|qo	A|Uh, well I'm in graduate school|^h
A|Uh, who is your, whose your favorite religious author?|qw	B|Well, I don't know if I have a favorite uh, religious author.|sd
A|so. What do you do?|qw	B|Um.|b
A|How many children do you have?|qw	B|Two.|sd
A|What school system does he go to?|qw	B|In North Garland,|sd
B|What school system are you familiar with?|qw	A|Okay,|^h
B|Well how do we how do we get that?|qw	A|Well, we're starting pilot schools.|sv
A|Pass or no fail, what is it?|qw	B|Yeah|b
B|and how many administrators is that going to take?|qw	A|I don't know,|h
A|What about you?|qo	B|Well, it's funny,|^h
B|So, uh, what do you think about our involvement in the Middle East?|qw	A|Well, actually, I think it's good.|sv
A|How old is your child?|qw	B|Ten,|sd
B|What division are you in?|qw	A|I'm not in T I.|sd
A|How does she get to work?|qw	B|Uh, she, uh, lives on campus,|sd
B|Where you from?|qw	A|I'm from Kilgore, Texas|sd
A|Oh, where you from?|qw	B|I'm, I'm originally from Lubbock.|sd
A|So, why did you move up to Colorado?|qw	B|Seemed like the thing to do at the time.|sd
A|What do you,|qw	B|uh, back to the topic,|ad
A|For how many years?|qw	B|Fifteen.|sd
A|So, how many years you been up there?|qw	B|Uh, six or seven.|sd
A|So, what kind of neat hobbies do you have?|qw	B|Well, I like gardening a lot,|sd
B|How many cats do you have?|qw	A|Three.|sd
A|But, uh, why would it be illegal?|qw	B|Well, because we have these uh,|sd
B|What kind of cats are they?|qw	A|Uh, I've got a, uh, a Bombay, a Turkish Van and a Himalayan Persian.|sd
B|What is it.|qw	A|It's a, well actually it's a mutant.|sd
A|what do you think, about Latin America?|qw	B|Uh, let's see,|^h
A|What are you taking in school?|qw	B|Well I am actually,|sd
A|you said, what were you saying you were teaching there?|qw	B|Yeah,|b
A|Where do you work?|qw	B|I work at channel six, here.|sd
A|or how many times have you been called?|qw	B|Um, I've been called a lot,|sd
A|but where in Virginia are you all?|qw	B|Um, right now, the District,|sd
A|What else?|qo	B|Um, well, I guess that I really don't know that much.|sd
B|What part of Maryland are you from?|qw	A|Up in the Gaithersburg area.|sd
A|How can they, how can they make you pay for insurance coverage?|qw	B|Well, the reason,|%
A|How, how does it keep the cost down?|qw	B|Because everyone is now forced to pay for this.|sd
A|How come their, their kids are getting that?|qw	B|Yeah.|aa
A|Just out of curiosity, what, what kinds of things were they doing when they were considered a bad place?|qw	B|Well, to me, it was dirty, for one thing.|sv
B|When was it out?|qw	A|Um, it's still out now, uh,|sd
A|What have you seen?|qw	B|One comes to mind here|^h
B|whose in that?|qw	A|It looks, it looks pretty suspenseful.|sd
A|where do you go to school?|qw	B|Uh, University of Texas at Dallas.|sd
B|Why is that?|qw	A|I don't,|%
A|How old are your boys?|qw	B|Oh, oh they're grown now.|sd
B|So, what's it been doing up there?|qw	A|It's real dry up here.|sd
A|Well, um, what movies are showing down there now?|qw	B|Oh, I, I'd actually have to get a newspaper out.|sd
A|what was that one about Bob?|qw	B|Uh, it's kind of, WHERE'S BOB? or WHAT ABOUT BOB?|sd
A|what kind of fishing do you do?|qw	B|Well, mostly, uh, a, a little fresh water fish,|sd
A|What, what kind of bait do you use to catch them?|qw	B|Oh, just, usually worms, night crawlers.|sd
B|Uh, what kind of fish do you like the best to eat?|qw	A|Oh, crappie actually.|sd
B|how many people were there?|qw	A|Oh, I, oh, I, jeez, I think over, um, three hundred were there.|sd
B|Now how many, how many people are in his immediate family?|qw	A|Well, he has eight brothers and sisters|sv
A|How about you?|qo	B|Well, we don't really get together,|sd
A|So what do you think?|qo	B|Well, I think the public school systems are doing a good job.|sv
B|So how long are we supposed to talk for?|qw	A|I'm not sure.|h
B|How about you?|qo	A|Well, I do, uh, little aerobics, oh, three or four times a week,|sd
B|What about you?|qo	A|Well, I think that society has come to a point where they're not responsible for any of their actions.|sv
A|What kind of movies have you been seeing lately?|qw	B|Uh, it's been probably a month or so since I've been to the movies.|sd
A|What was that anyway?|qw	B|Oh, it's a, I guess it's a mystery, you'd call it.|sd
B|What are you?|qw	A|Uh, we've not been having many opportunities to see movies lately.|sd
B|What'd you think of it?|qw	A|Oh, we loved it.|sd
B|What are,  what are the problems with public education?|qw	A|Well, um, there, there's some.|sd
B|And what what kind of books do you read?|qw	A|Uh, just really different ones.|sd
A|What kinds of things do you fix?|qw	B|Well, essentially anything you find in a house. Uh, a stove, or oven or a broken piece of porcelain or, uh, chipped tile on the floor. I mean just anything.|sd
A|What do you think about gun control?|qw	B|Well, uh, sort of mixed feelings about it, I guess, uh, uh,|sd
B|What about yourself?|qo	A|Well, I guess that I would like to, to say that perhaps someplace in the middle where people could somehow qualify or, uh, have a legitimate use for the, the, the weapon I suppose because also, living in this area, the, the problems in D C come home very quickly.|sv
A|What sort of requirements to you have for your car?|qw	B|Uh, sports car.|sd
B|What about you?|qo	A|Well, I guess I'm, uh, more traditional in that I don't like power windows or power locks, because the people that I know who have them always seem to have trouble with them.|sd
B|What was that?|qw	A|It, it turned out to be a, a Chrysler. Uh Lancer.|sd
B|Why why did you want one?|qw	A|Well, I just wanted it because, again, I had, I guess traditionally always had a car that had one|sd
A|And so why do you like stick shift?|qw	B|Uh, I guess I, I grew up on it and it's fun.|sd
A|What do you like to do in your spare time?|qw	B|Well, and when I have my spare time I do enjoy,|sd
A|What kind of music?|qw	B|Well I enjoy singing.|sd
B|What kind of fishing do you do?|qw	A|Well, it's mostly from the rivers and lakes.|sd
B|Well, what kind of fish do they have in your neck of the woods?|qw	A|Well, it, uh,|%
B|how  do you, how do you,|qw	A|We, uh,  skin them.|sd
A|How did you get on this list?|qw	B|Uh, through Nancy Dahlgren.|sd
A|What ideas do you have on that, Doug?|qo	B|Um, see, I'm not sure that,|%
A|In what manner?|qw	B|Well, it's certainly not that difficult to tap a phone.|sd
B|well, what's the first thing that comes to your mind?|qo	A|Well, the thing that I thought they were, uh, concerned about was, was people calling on the phone from all over the country to sell you something|sv
B|So, what is your opinion on, on drug testing?|qw	A|Well I can see it in certain cases where it might be, uh, somebody's in a position that, uh, perhaps a lot of lives are involved, like, maybe, uh, pilots that, uh, you know, fly jets|sv
A|you know how can  how you can do it?|qw	B|Well,|%
B|It's what do you do with the information?|qw	A|Sure.|aa
A|Where  there might be in the back of the mind of the employer that this person, uh, is on drugs|qw	B|Right.|b
B|where would you camp  ?|qw	A|Well,  there's, uh, places in Wisconsin.|sd
A|what is your favorite, um, food for a dinner party?|qw	B|Um, I don't know,|h
A|how do you make fajitas?|qw	B|Um, it's kind of like made out of skirt steak|sd
B|So, what kind of cooking do you do up there?|qw	A|Oh, well, basically, um, because I lived in the Middle East for a while I tend to fix Middle Eastern foods when I have, have people over.|sd
B|How|qo	A|Oh, I think so, too.|aa
A|What do you think on the local elections though?|qw	B|I think on the local elections it's actually, um,|sv
B|What do they have to do with one another?|qw	A|I just, I, they, I just wandered off from that one.|sd
B|So, how do you think we can get people to vote?|qw	A|Uh, uh,|%
A|How old were they when you adopted?|qw	B|The baby was eleven weeks old|sd
B|How  do you blow yours up?|qw	A|We've got an electric pump that hooks into the cigarette lighter.|sd
A|with How many weeks have you been doing these calls?|qw	B|Oh, since the beginning.|sd
A|And what exactly are they going to do?|qw	B|Oh, they turn them over to somebody|sd
B|How about your,|qo	A|She does it all now for about ten years,|sd
B|And, and how did your daughter get scholarship money on?|qw	A|Uh, band.|sd
B|Um, how many children do you have?|qw	A|I have two.|sd
B|What about in our work ethics?|qo	A|Work ethics, oh,|b^m
A|So, so what changes have you seen?|qw	B|What changes, uh,|t1
B|Which do you work in, excuse me?|qw	A|A government.|sd
B|How do you feel your career has gone?|qo	A|I don't, I don't feel for the most part that I've been discriminated against.|sd
B|How is your what is your feeling about uh uh expressing yourself by burning the American flag?|qo	A|Well I'll tell you.|^h
B|What does speech have to do with burning a flag?|qw	A|Yeah.|b
A|You were, he was waiting for what again?|qw	B|To,|%
A|what do you like?|qo	B|Well  we  don't have a T V,|arp_nd
A|How long has it been since you've had one?|qw	B|Well, about, almost a year.|sd
A|where are you calling from?|qw	B|Uh, Sherman, Texas.|sd
B|Where are you from?|qw	A|I'm in Dallas|sd
B|What was that?|qw	A|That guy that was a reporter for C N N.|sd
B|but what about this Wolf guy?|qo	A|Yeah,|b
A|where did you go to school?|qw	B|Oh, Purdue.|sd
A|How many kids do you have?|qw	B|Two.|sd
A|where you at?|qw	B|I'm in Rome, New York.|sd
A|What, what type of area is that,|qw	B|It's more rural,|sd
A|How would,  how is the situation in there in terms of crime and,  and things that  would,|qw	B|it, you know, you still have the, uh, more drug problems and typical,  uh,  small city type problems,|sd
A|how about the injection,|qo	B|Oh, yeah,|b
A|What do you think?|qo	B|Well, I think it is, uh, basically the same way.|aa
B|Where do they live?|qw	A|Uh, well, I have a son and daughter that live in Pittsburgh. One in Maryland and one in Connecticut.|sd
A|How old are you?|qw	B|I'm thirty-five.|sd
B|When you say you're in the second phase of this project, what is the second phase of it?|qw	A|I'm not sure,|no
B|How do you gain your news?|qw	A|I guess the, I get the WASHINGTON POST|sd
A|Well, Carolyn, the, uh, one of the main things I'd like, like to know is, uh, how do you feel about the, knowing about the environment of a nursing home before you would send someone there to live and so forth.|qo	B|Well.|%
A|What do you think would be required, and so forth?|qo	B|Uh, I'll tell you,|^h
A|but how do you think they would feel, I should say, about moving from where they have lived most of their life into a whole new, new home situation?|qo	B|Well, actually, I have that kind of situation, because my mother lives with me,|arp_nd
A|What's it called?|qw	B|Uh, I don't know,|no
B|Which which one does, which ones do you like?|qw	A|Just really whatever.|sd
B|where do you go to school?|qw	A|B Y U.|sd
B|What did he teach?|qw	A|Uh, speech pathology.|sd
A|How long have you been there?|qw	B|Uh, this is my first semester.|sd
B|Who, Who, who, who, what, when did he teach?|qw	A|He, Uh, he taught about a year ago.|sd
B|what's his name?|qw	A|Allen Bird.|sd
B|Uh, what are you studying?|qw	A|Uh, I was, I am studying nursing|sd
B|What do you play?|qw	A|Um, clarinet is my primary instrument,|sd
A|How about yourself?|qo	B|I play, uh, the violin and play trumpet|sd
B|How many people in your band?|qw	A|Um, I think there's about seventy.|sd
B|Well, what do you think?|qo	A|Well, providing universal health care insurance for the whole country is a pretty big task|sv
A|How do you feel about the whole ordeal?|qo	B|Well, I agree that it's a big task,|aa
B|What do you like to cook?|qo	A|Uh, I don't cook a lot actually.|sd
B|Well, what else do you put in it besides the celery seed.|qw	A|Just like, uh, really fine onions and green pepper and the celery seed|sd
A|Well, what kind of music do you like?|qo	B|Well, seeing as how I'm a musician I like all kinds of music.|sd
A|Who are the trumpet players?|qw	B|Well, we used to have, uh, Ralph Dutchen.|sd
B|Who was your trumpet teacher?|qw	A|John Nelson.|sd
A|Which Church is it?|qw	B|The Christ United Methodist Church in Plano|sd
B|How did, How did they get involved in that?|qw	A|Uh, basically they read in the newspaper that there were open auditions.|sd
B|And, uh, who do you have her, or him, take it from?|qw	A|Uh, I have him take from a friend of mine who teaches Suzuki. Which is an auditory type learning experience.|sd
B|How about you?|qo	A|That's kind of, uh,|%
B|Where are you at?|qw	A|Yeah, uh,|b
A|How do you feel?|qo	B|Well, yeah.|b
B|What, uh, what area did you live in?|qw	A|I was up in Arequipa .|sd
A|Are, where you from originally.|qw	B|Uh, right here in Maryland.|sd
A|So, how do you feel about the metric system?|qo	B|Oh, I like it.|sd
B|How many ounces of gold, you know.|qw	A|Twelve.|sd
B|But what's a metric ton?|qw	A|Uh,|%
A|What have you been to lately?|qw	B|Um, let's see.|^h
A|How's his karate?|qw	B|Oh, his, his, his karate is pretty good.|sd
A|What is your most recent,|qw	B|We just did that, too.|sd
A|what do you do with your credit cards?|qo	B|Oh|b
B|How about|qo	A|I think you are, I think you are earlier than we are, as a rule, aren't you?|qy
B|Um, what is your humidity like?|qw	A|Oh, I don't know.|no
A|How long will they be there?|qw	B|Uh, probably four or five days.|sd
B|Where do you live?|qw	A|Rowlett, Texas.|sd
B|What do you think invades your privacy? heavily|qo	A|Oh, well people that call on the phone all the time to try to sell you something. You know, that, that try to sell you the newspaper, and, uh, carpet cleaning, and, uh, what else, roof repair|sv
B|what's that?|qw	A|M C I|^h
A|Who makes that car?|qw	B|Nissan.|sd
B|if you could have the car that you wanted what would you get|qw	A|If, if, if I had the car I wanted.|^h
B|and why?|qw	A|Gee.|ba
A|How about you?|qo	B|Yeah,|b
A|How about you?|qo	B|Oh, yeah,|ny
A|Oh, how was it?|qw	B|It was, uh, it was great.|sd
A|So, what are your thoughts on dining out?|qw	B|Well, I, I really choose restaurants more for the quality of food than anything else.|sd
A|And where was that at, near your,|qw	B|Um, Kalachandji's.|sd
B|Why?|qw	A|No,|nn
B|Now why would you go to a seafood restaurant to eat chicken?|qw	A|Oh, it was,|sd
B|Why?|qw	A|Because of all the pollution in the lakes and the, everywhere. I mean there isn't any safe haven anymore for fish.|sv
A|Well, why do you think,  people don't.|qo	B|Don't always  vote for somebody.|sd
A|Uh, so, uh, what do you consider the most important benefit besides salary?|qo	B|Boy, I, I don't know.|no
B|What, what about you?|qo	A|Well, uh, I, right now I'm in sort of a weird situation.|sd
B|Well, how do you feel about spot spot testing for drugs?|qo	A|Well, basically I think it would be a good idea myself.|arp_nd
A|Where, where  is it they lose the, if they steal they lose a  thumb or a finger?|qw	B|That's right.|aa
B|Uh, what, what contacts do you have with the public school|qo	A|Okay,|b
B|What do you do with all those?|qo	A|Well, actually on my Commodore I mainly study lottery numbers, would you believe.|sd
A|So how about you, Charles?|qo	B|Well, I, um, I do an awful lot of preparation of documents, um, uh,|sd
A|So, where, may I ask where you work, sir?|qw	B|I work for the government in Washington.|sd
A|Uh, what do you think are the major social changes?|qo	B|Well,|%
A|What age, uh, if you don't mind me asking.|qw	B|Well, I'm, I'm, uh, thirty-one.|sd
A|Well, what do you think is, is the major social change?|qo	B|Oh,|^h
A|uh, what do you consider an invasion of privacy?|qo	B|Uh, I was just now told that's what the topic was|sd
A|What do you think of that?|qo	B|Uh,|^h
A|How about your community?|qo	B|My community,|b
A|Well, in, in Dallas, what are the, what is the newspaper situation?|qw	B|Well we we, we have a, a big newspaper situation.|sd
B|Uh, you know, you know, you know what I mean|qw	A|Yeah.|ny
A|And, uh, what kind of running do you do?|qo	B|They have got the track on the inside.|sd
B|How about you?|qo	A|Yeah,|b
A|So so, so how do people in Wisconsin dress?|qo	B|Oh, yeah|b
B|What kind|qw	A|And.|%
B|How long does it take you to make one?|qw	A|Uh, if I would just work all day long, making the clothes and everything, probably about two and a half days.|sd
B|Well, how did you get involved in that?|qw	A|Just, you know, just like sewing and stuff and decided to buy a pattern and try to make a doll.|sd
B|What design did you use?|qw	A|Uh, mostly flowers you know.|sd
B|And, what room?|qw	A|I've done it in the all, uh, all my rooms.|sd
A|Where are you, Bob?|qw	B|I am in Plano.|sd
B|Where are you?|qw	A|Oh, okay.|bk
B|Who, who do you work for?|qw	A|Uh, I work for Channel six.|sd
A|What is your,|qw	B|I sell metal fabricating equipment and tooling.|sd
B|How do you like to camp?|qo	A|Oh, I can camp just about, most anyway|sd
A|What kind?|qw	B|Uh, copperheads mostly,|sd
A|What about you?|qo	B|Well, I think,|%
B|What made you all decide to put her, or what made her decide to go?|qw	A|Well, her husband died.|sd
B|How do, how do you feel about people like Jesse Jackson getting involved?|qo	A|Uh, I think sometimes it's good for people outside.|sv
B|What do you think of him?|qo	A|Oh, um, I think he's got good intentions,|sv
B|what do you think of this, uh, fourteen one and ten four one in Dallas?|qo	A|Oh, I think that they should go ahead and go to the, uh, fourteen one.|sv
B|what's, what's the lady's name?|qw	A|Diane Ragsdale?|qy
A|um, how do you feel about, um, the way the U S has reacted in the Middle East?|qo	B|Well, I was, it was favorable.|arp_nd
A|What is the Woodward book you are referring to?|qw	B|Well, it just came out, I guess, yesterday.|sd
A|And, um, what about the whole situation with the refugees, the Kurds?|qo	B|Well, I would just think if Bush was so successful in lining up the correlation to prosecute a war, then he should be equally successful in getting that same correlation to push the United Nations to, uh, uh, somehow persuade those nations to give the Kurds a homeland|sv
A|But, what about the Palestinians?|qo	B|Well, that's the same thing,|sv
A|what is it, uh, the act where they had to cut everything across the board|qw	B|The Gramm,  the Gramm Rudman Act.|sd
A|who's, who's supposed to have the, the, uh, the best, uh, draft picks?|qw	B|It doesn't even say.|sd
A|But, uh, so who do you thinks going to win the playoffs?|qw	B|I don't know,|no
B|How's the weather been out there?|qw	A|Well, the last three days it's been pretty rainy.|sd
A|How about yours?|qo	B|It's pretty normal for this year, you know, uh,|sd
A|How how far are you from Houston?|qw	B|Um, well, uh, Richardson's a suburb of Dallas.|sd
A|or what was it?|qw	B|Um, I think lots of people, I, I think I went by location for one thing.|sv
A|Oh, where you from Tina?|qw	B|I live in Garland, Texas.|sd
B|what is real popular up there?|qw	A|Well, I don't know,|no
B|Well, how did you go about selecting a college, then?|qw	A|Well, we did not do it right all the time|arp_nd
B|How about the other four, other three who went?|qo	A|Uh, the other ones, uh, the second one, she chose, we let her go where she wanted to, uh,|sd
A|How much chili sauce did you say?|qw	B|It's one of the small bottles.|sd
A|And how much crab meat did you use?|qw	B|One tin. Of the flake.|sd
A|Whose was that?|qw	B|It, uh, was, uh, Lawry's, I believe, or Lawler's.|sd
A|And how old is your baby?|qw	B|She just, uh, well, she was premature,|sd
A|how's the weather been in Plano?|qw	B|Basically about the same as what you've probably had.|sd
B|What is it about, nursing homes?|qw	A|well, about nursing homes, and, and older people.|sd
B|how old is she?|qw	A|She's ninety-two.|sd
A|What have you found in dealing with the nursing homes?|qw	B|Well, they're not, every, all the horror stories you hear about them I think are true.|sv
A|what kind of car are you going to buy next?|qw	B|Well, one of the cars I'm thinking about buying next is, uh, a nice, safe, small car,|sd
B|What, what are you looking at?|qw	A|Well, I'm really not looking at anything for a while,|arp_nd
A|on a scale of one to ten where do you stand and why?|qw	B|Well, I guess I stand on, uh, on, probably ten for no, uh, restrictions.|sd
A|Uh, what about, uh, what do you think of this, this, uh, law that they're putting into effect that you have to wait X number of days before you can, uh, carry the gun, or buy, you know, actually purchase the gun?|qo	B|Well, you know, they introduced some gun control back when I was a teenager, I believe, in terms of, uh, every gun you bought had to be licensed, I believe.|sd
A|Oh, how was that?|qw	B|Oh, it was excellent.|sd
B|How do you feel about it?|qo	A|Well, so, let me make sure,|^h
B|So, how do you feel about guns?|qo	A|Let's see,|^h
B|Then, uh, how do you propose that we prohibit those types of individuals from gaining access to guns?|qo	A|Well, we have some laws on the books that, uh, don't allow convicted felons to purchase guns, if I understand correctly.|sd
A|So how is work going?|qw	B|Very fine,|sd
B|How about where you live there in Utah?|qo	A|Okay, Howard,|fo_o_fw_"_by_bc
B|Well, where do you think we ought to go with it?|qo	A|Uh.|^h
B|So, uh, so what do you, what do you think in the short term we should be doing to, to improve it?|qo	A|Well, I saw a program on, uh, recently,|sd
B|Where, where do you like to go when you got a baby-sitter?|qw	A|Oh, um, let me see, uh, for New Year's we went to eat at Uncle Julio's.|sd
B|What's the name of that again?|qw	A|It's called Uncle Julio's.|sd
B|What, what are they, what kind of?|qw	A|Um, basically Mexican food.|sd
B|Where's that place?|qw	A|That's in Addison, off of Belt Line.|sd
B|Belt Line  and what?|qw	A|Like around, I think it's a little past or it's right before Midway, or it's right at Midway.|sd
A|What, what is that?|qw	B|Well, you get, uh, one free|sd
A|And where is that?|qw	B|Uh, it's on Campbell. It, it's north of Campbell, but, uh, off Central, uh|sd
A|So, how do you use your credit cards?|qo	B|Oh, we use them for, paying our gas and for paying, uh, just about anything, because, um, we don't like to pay for our checks|sd
B|What kind of things do you like to do with wood?|qo	A|Well, I'm not the one that cuts them out.|arp_nd
B|Well, how is the market for things like that in California?|qw	A|It seems, it seems like they go real good,  you know.|sd
B|But when you were growing up and they weren't, and the younger ones weren't around, what did you do?|qw	A|We were all pretty close when we were younger.|arp_nd
A|but, But, uh, so what, what do you like, why do you like DAVID LETTERMAN?|qw	B|That's psychedelic.|ba
B|how long is it?|qw	A|Uh, I don't know,|no
B|Which basketball?|qw	A|College or,|qy
B|So, so why from Argentina, why'd you come over here?|qw	A|Uh, because, uh, I wanted to go to school here.|sd
B|How long did you live there?|qw	A|they have better computer science up here than they, than they do down there.|sv
A|I, uh, was thinking about salaries and benefits and uh, was wondering what's the most important thing to you besides a salary in a job.|qw	B|Uh-huh.|b
A|what do you think about the women that are not having families because they want to continue their business?|qo	B|That's fine,|sv
B|what do you feel the changes in the future, like with the abortions and that type of thing, women in politics and president someday, maybe|qo	A|Uh.|%
A|Where's that?|qw	B|It's about two hours north of Pittsburgh.|sd
A|How long have you been doing this?|qw	B|Um, I've been a vegetarian for, uh, two years now.|sd
B|So what do you look for when you,|qw	A|Uh, I think the main thing that I look for is, uh, cleanliness, uh, you know, the, in the appearance of the people that work there. And the, uh, quality of the food that they serve.|sd
A|So what movies have you seen?|qw	B|Uh, well, I have, uh, seen DANCES WITH WOLVES, which is probably the, the best movie that I have seen lately.|sd
B|How about you?|qo	A|Yeah.|fo_o_fw_"_by_bc
B|Who wins?|qw	A|Uh, he does.|sd
B|How much is it in Dallas?|qw	A|Well, it is six dollars,|sd
B|As far as the, as the trends?|qo	A|Well, I think they are a lot better than they than they were,|sd
A|Oh, what did you get?|qw	B|I got a nineteen ninety-three Cavalier station wagon.|sd
A|what, what convinced you to get that one?|qw	B|Well, a friend of my father's, and he'd driven it all over the country and it runs great.|sd
A|how many miles on it?|qw	B|It's like, it has a hundred and fifty-three thousand.|sd
A|So, uh, if you were to buy a new car now, a brand new car, what would you look for?|qw	B|Um, like you said, anti-lock brakes and air bag,|sd
B|well, how do you get your name off the junk mailing list?|qw	A|Uh, you, you, you, you do that by, uh, um,|sd
B|Where did you go?|qw	A|I went to Clarion.|sd
B|where are you going to move to?|qw	A|Uh, Maryland.|sd
A|What is your opinion?|qw	B|I say yes.|sv
A|How about yourself?|qo	B|Well, actually I've done both kinds|sd
A|what's a license cost?|qw	B|Well, as I say, it's been several years,|sd
B|but, uh. How about you?|qo	A|Well, I watch, um,|sd
A|what do you think about the war recently?|qo	B|The war?|qy^d
A|what kind of music do you like?|qw	B|Well, I, uh,|%
B|What about you?|qo	A|Um, I listen, I listen to a wide variety of music.|sd
A|What instrument does he play?|qw	B|He plays the,|sd
A|What did they want to charge you for it?|qw	B|Oh, it, it was, it was|%
A|Well, what kind of garden do you have?|qw	B|Well, we've tried having,|sd
B|So what do you do up there?|qw	A|Well, um, actually it,|%
B|How many people usually show up?|qw	A|Oh, about ten.|sd
B|What do you feed them?|qw	A|Uh, mixed Purina, uh,|sd
B|How big do they get?|qw	A|Oh, well, the channel catfish get up to, uh,|sd
B|what's your views on it?|qo	A|Um, for myself, I'm personally against it,|sd
A|And, uh, where do you get yours?|qw	B|Uh, mostly from T V too.|sd
B|What islands did you go to?|qw	A|We went to Oahu and Kauai.|sd
B|How old were you when you left?|qw	A|Uh, just ten months.|sd
B|How about you?|qo	A|Well we moved in, when we moved in, there, there wasn't any outside lights|sd
B|How do you like your tread mill?|qo	A|I like it.|sd
A|Where do you|qw	B|I live in Arlington.|sd
B|Where do you live?|qw	A|I'm in Garland.|sd
B|Uh, what subjects have you talked about?|qw	A|Let's see,|^h
A|Well, how'd you find out about it?|qw	B|Pardon me?|br
A|How did you find out about it?|qw	B|Oh, I don't know.|sd
B|How many children do you have?|qw	A|Two.|sd
A|Where's you|qw	B|putting two of us through, isn't he lucky.|sd
A|Where you going to school?|qw	B|U T A right here.|sd
A|And what are you doing?|qw	B|Well, I'm, um, going to be certified as an English teacher teach English as a second language.|sd
B|Well, uh, what kind of recycling do you have in your area?|qw	A|Well, they've been trying different things.|sd
B|which one is that?|qw	A|Owens.|sd
A|And what is T I?|qw	B|Uh, Texas Instruments.|sd
A|Uh, maybe you could tell me, what is the difference between office paper waste and just like newspapers?|qw	B|Well, I guess I don't know specifically, except that, uh, for the paper that they want to recycle, they do not want any newspaper, um, and things like candy wrappers or, uh, that type of thing.|sd
A|About how many calls have you made on this system?|qw	B|Uh, I've originated only a, a few.|sd
B|Well, what would be the difference between that and social security?|qw	A|Uh, well social security's going to go to way, I think|sv
A|What other benefits,|qw	B|uh, retirement.|sd
B|What about vacation?|qo	A|I'm satisfied with the vacation.|sd
A|So, what do you think of our trial system?|qw	B|Huh, I don't really know what to think about it,|h
B|Well, well, how was he killing the women.|qw	A|Um, he was strangling some of them.|sd
A|what, what major changes have affected your life?|qw	B|Well, I think that, uh, women, women working is the one that really affects me most strongly right now.|sd
A|But for how many years?|qw	B|I don't, I don't know.|sd
B|how do you just,|qw	A|Right,|b
A|How many kids do you have?|qw	B|I have four children.|sd
B|Now what is that?|qw	A|I remember him in school,|sd
B|What channel is it on?|qw	A|It is on channel,|sd
B|What was that?|qw	A|I don't know|sd
B|What are they like?|qo	A|They are very nice.|sd
A|And how many does it sleep, uh, comfortably?|qw	B|Well, there, well supposedly,|sv
B|And how long have you had them?|qw	A|The|%
A|What kind of dog do you have?|qw	B|Um, she's, um, a mix of Cockapoo, Cocker Spaniel and Poodle.|sd
B|What color is your dog?|qw	A|White.|sd
B|Um, how long did you have that?|qw	A|Oh, my, how, how long?|bf
A|What do you have there?|qw	B|Uh we have a six percent sales tax.|sd
A|Where did you go to school?|qw	B|Clarion University.|sd
A|What do you do there in Lubbock as far as, uh, recycling is concerned?|qw	B|Well, you know they actually started|sd
A|what would be more efficient about it.|qw	B|Uh.|%
B|So, uh, what else do they do in the Dallas area?|qo	A|Well, uh, as far as T I is concerned, I'm not sure.|sd
B|What, what, uh, what part of Pennsylvania are you in?|qw	A|Um, I'm north of Pittsburgh,|sd
A|So, what is your latest experience with painting?|qo	B|Well, I don't,|%
B|Well who would you say is your favorite player, or has ever been your favorite player?|qw	A|Ever been?|qy
B|Well what did you think of, um. a couple years ago for the Bears, the Refrigerator.|qo	A|I think he was just probably a passing phenomena, I think|sv
B|What about, uh, Marino?|qo	A|Uh, I'm,|%
B|but it was, uh, basically what's your views on, whether you thought there was certain cases that should be used, that sort of thing?|qo	A|Yeah.|b
B|how do you feel about it?|qo	A|Uh, I believe in it, too|sd
B|Um, so where do you live in Pennsylvania?|qw	A|In Clarion.|sd
A|So, how do we fix the national budget?|qw	B|Damned if I know.|sd
B|well, why do you say that actually?|qw	A|Uh, too few Americans are working.|sv
B|what kind of crafts and hobbies do you have?|qw	A|Oh, not very many of those at, uh,|h
A|Um, how about you?|qo	B|In,|%
B|But, uh, what are some other things you enjoy?|qw	A|I don't know.|h
A|what do you read?|qw	B|Uh, well, I read everything, uh, I guess, uh,|sd
A|What is your favorite?|qw	B|Uh, well, I like all kinds, uh,|sd
B|But, uh, what do you read, I guess, in general?|qw	A|Oh, well,|%
A|What is his name?|qw	B|uh, Trump.|sd
A|What type of home do you have in Dallas?|qw	B|We have a, uh, four bedroom split brick home in, in Richardson actually.|sd
B|Well, how many bedrooms do you have in your home?|qw	A|I have, uh, a master bedroom and a den on the main floor,|sd
B|Where did you move from?|qw	A|Uh, Detroit this last time.|sd
A|well, what, uh, what do you all do for camping?|qo	B|Well, we don't do so much now,|sd
A|Where do you go?|qw	B|We, uh, years ago we lived in Oklahoma|sd
A|Uh, what, what, has been your favorite trip do you think?|qw	B|Well, I am not sure.|sd
B|So how about you?|qo	A|Yeah.|b
A|How do you dress for work?|qw	B|Well, uh, uh about the same I dress for school.|sd
B|How about you, Larry?|qo	A|Well, I'm relatively fortunate about that.|sd
B|how do you feel about, about all this smog and stuff on cars.|qo	A|Uh, well, I'm kind of a car buff myself,|sd
A|well, what do you think if you're in that, you know, if you're concerned about that,|qo	B|Well,|%
B|and who decides what you do with it?|qw	A|Yeah,|ny
B|And what do they do with it?|qw	A|Well, we buy things for the dorm, whatever the dorm needs, you know.|sd
B|Well, what are you going to do when you get out of college?|qo	A|I'm a finance major.|sd
A|What do you think the outcome will be?|qw	B|I think they're maybe going to give us a state income tax.|sv
B|What do they think about Texans?|qw	A|What do we think about them?|qy
A|what you think about Pennsylvanians.|qo	B|Probably a lot more civilized, more, um, refined than a lot of the people would be down here.|sv
B|What, what does a nonexempt sound like?|qw	A|Uh, you're too informed.|sv
A|Where, where are you from?|qw	B|Um, just here in Dallas.|sd
B|What kind of meals did she make that you liked?|qw	A|Well, she was Polish|sd
A|Uh, how do you mean that?|qo	B|Well, I mean, okay,|sd
B|How, how did your daughter do it?|qo	A|Uh, well, uh, I have one daughter that works full-time.|sd
B|In what field?|qw	A|Well, uh, in information systems.|sd
A|what type of things would you fix if you're having company come over?|qw	B|Well, I have a really great one that I make in the summertime because it's cool|sd
A|How old is he?|qw	B|He's eleven.|sd
B|Oh, which state is that?|qw	A|Uh, State of Minnesota.|sd
A|What kind of pet do you have, Gail?|qw	B|Well, I don't.|arp_nd
A|Uh, what have you had?|qw	B|Well, we had a dog before we moved here.|sd
B|How are you?|qw	A|Great, Nancy.|sd
A|Which one?|qw	B|Uh, Jazz.|sd
A|What was your name again?|qw	B|Nancy.|sd
A|What, uh what do you feel are important to you or other people as, as crucial benefits?|qw	B|Uh-huh.|b
A|And, uh, what other benefits do you think are important?|qw	B|Oh, well, I guess, retirement, that kind of thing which I don't worry much about so|sv
A|What was she driving?|qw	B|It was a Cadillac.|sd
A|Uh, and like, what were you replacing the starters and bendix on?|qw	B|Uh, a Maverick and also, uh, a Chrysler station wagon before that.|sd
A|Anyway, what are you driving now?|qw	B|Uh, my Chrysler van|sd
B|Where'd you move from?|qw	A|Houston.|sd
A|what, uh, what's your experience been like?|qo	B|Well, I, uh, I have a long experience with cars.|sd
B|in terms of talking about restaurants, I mean are a lot of restaurants, how are they when you have children let alone three or four children?|qo	A|You have to be careful if you go to a, a restaurant that,  that  really is more adults you know,  with  the atmosphere and everything,|sd
B|What, what age child are you thinking in terms of?|qw	A|In terms of what they're talking about.|qy^d
A|What part of the country are you in?|qw	B|I'm in Maryland.|sd
A|what country were you, uh, in Europe when you were uh, uh?|qw	B|No,|ar
B|How did it influence them?|qo	A|Uh, the, the one guy I worked with down in Austin hated it.|sd
B|What world war do you think they found the experience for that?|qw	A|Uh,|%
A|What do you, what do you think about them?|qo	B|Well, I think they're useful,|sv
B|so who do you work for?|qw	A|I just graduated from college.|sd
A|What do you take?|qw	B|Well, I actually take COUNTRY LIVING,|sd
A|What, uh, what do you use as a basis to determine which college or university you go to?|qw	B|Well I use, uh, uh, uh, I have used, uh, several techniques depending on what,|sd
B|Where, where did you go?|qw	A|I went to Utah State University which is in Logan, Utah|sd
A|So, what do you think about a year or two of public service?|qo	B|Well, I know it's hard for young people to think about giving up their years, you know, their carefree years|sd
A|What did he say about it?|qw	B|Oh, he wanted to take the current secondary highway system and turn it into interstates like the rest of the country.|sv
B|What's that?|qw	A|I'm sorry, I dropped the phone|fa
B|How far west have you been?|qw	A|Only in Ohio.|sd
B|Uh, how high is the highest elevation?|qw	A|Oh, I couldn't even tell you.|sd
B|How many hours have you been from home?|qw	A|Uh, the farthest away from home?|qy^d
B|What's your major?|qw	A|Finance.|sd
B|So, uh, what do you plan to do with it?|qw	A|Um, well, like I said my fianc3ee, *typo|sd
A|Well, well what would be the unemployment rate out there?|qw	B|Uh, unemployment runs approximately six percent.|sd
B|What's your, been your experience?|qw	A|Well, I, I was going to ask, too, does your wife work?|qy
A|What line of work are you in now since you went to school okay.|qw	B|Uh, well, now I work for Texas Instruments.|sd
A|The other thing then is, because I don't know how long they want us to talk,|qw	B|Oh, close to five minutes, I believe.|sd
A|What do you like to watch on television ?|qw	B|Well, I guess a lot of the, uh,|sd
A|So what's, uh, things that you look for when you go out to dinner?|qw	B|Oh, I just like a nice, quiet, nice atmosphere and of course good food|sd
B|Well, how's California today?|qo	A|Oh, it's foggy and cold here.|sd
A|Has, what's been your voting experience?|qo	B|My voting experience?|br
B|what part of, uh, Pennsylvania do you live in?|qw	A|Uh, are you familiar with any of the area that all?|qy
A|Where?|qw	B|Uh, near, uh, Philadelphia.|sd
A|Uh, Kate, what kind of, uh, where do you like to eat out?|qw	B|Well, we, uh, we really like the Mexican food, you know, here in Texas|sd
B|Where's that at?|qw	A|That's at Skillman and L B J|sd
A|Well, what else do you like?|qo	B|Well, I love, uh, I love seafood|sd
A|How about you?|qo	B|Well, I think they waste what we pay.|sv
A|What part of the country are you in?|qw	B|Uh, Pennsylvania.|sd
B|What part of Pittsburgh?|qw	A|Um, the South Hills area, Beaver County, well originally Beaver County .|sd
A|And, uh, where are you from?|qw	B|Uh, Clarion County.|sd
A|How many square feet do you have?|qw	B|Uh, oh, golly,|ba
A|What do you think?|qo	B|Well, uh, this is, this is about drug testing right?|qy
B|How about you?|qo	A|Yeah,|ny
B|what percentage of, of corporations and, uh, private industry do you think use, uh, drug testing?|qw	A|I think it's, it's more frequent now.|sv
A|and how many do you have?|qw	B|We have two children,|sd
A|what do you, what activities do you do with your children when you are together?|qw	B|Oh, most the  time,|%
A|what do you think of, uh, of the current trends of how other people spend time with their children  and so forth?|qo	B|Oh, I,  I think the trends are going back to spending more time with families.|sv
A|But, uh, what kinds of things do you and your family do?|qo	B|Um, well, we go out and fly kites|sd
A|What kinds of things do you think can?|qo	B|Well, I think they can turn off the T V for one thing. And, and go out and do stuff, you know.|sv
A|How, how old is she?|qw	B|she's five.|sd
B|Do you like, what do you like to go for?|qw	A|Oh, it's, it's, uh,|%
A|What do you, what do you catch perch on?|qw	B|Uh, I, they actually, they,|%
A|like in a room filled with What do you think about the benefits in jobs?|qo	B|Um, I'm, I'm relatively satisfied with the benefits I have.|sd
B|What about you?|qo	A|Yeah,|ny
B|Are there others that you're dissatisfied with?|qo	A|Well, I work for Sears,|sd
A|how old, is your oldest?|qw	B|before,|%
A|What,   What?  What all do you know about it?|qo	B|Uh,   okay  ,|b
A|What have you got up there?|qo	B|Well, I, I live out in the country,|sd
A|Why don't you tell me what you have found.|qo	B|Well, uh, the,|%
B|And how old was he?|qw	A|He's now five and a half.|sd
A|could you tell me what you think contributes most to, uh, air pollution?|qw	B|Well, it's hard to say.|^h
B|What do you think?|qo	A|Um, well, you talked about, uh, volcanos.|sd
B|How about you?|qo	A|well it's, it's,|%
B|I mean, what do you think we can, uh, I guess as individuals or as a group, do about, uh, air pollution?|qw	A|Uh, we can demand, uh, more efficient automobiles for one thing.|sv
A|Uh, when was the last time you saw a truck that didn't belch, smoke, or, uh,|qw	B|Yeah,|b
B|What are your music interests?|qw	A|Uh, just about any kind of music except acid rock|sd
B|Well, what kind of music do you not like?|qw	A|Well, like I say the acid rock,|sd
A|How about yourself?|qo	B|Uh, I agree with you.|aa
B|How about you?|qo	A|Oh, well, I'm kind of off and on.|sd
A|what type of exercise do you do?|qw	B|Uh, I do walking on the treadmill,|sd
A|How often do you, uh, uh, go out each week on your walking?|qw	B|Well, I do,|sd
A|how far, about how far do you go walking?|qw	B|Well, I'm trying to get my tolerance now|^h
A|Which, uh, shows do you watch on T V?|qw	B|Um, it's a, it's a|%
A|and, uh, what is the other one called.|qw	B|There was one guy I use to watch on E S P N,|sd
B|Uh, well what would you say your opinion is on gun control?|qw	A|Well, I don't know.|h
A|Uh, how do you feel about it?|qo	B|Well, I think, uh, down here in Texas they don't have a waiting period on handguns.|sv
A|How  long was the waiting period out there?|qw	B|About nine days.|sd
B|Where you from?|qw	A|I'm from New England.|sd
B|What is she?|qw	A|She's, uh, uh, uh, a poodle.|sd
A|What is that sound?|qw	B|That's my buzzer at the door|sd
B|Uh, so what do you do to exercise?|qw	A|Uh,|%
A|What about yourself?|qo	B|That's pretty impressive.|sv
A|How long does that take you to get to work?|qw	B|Uh, about forty-five, fifty minutes.|sd
A|How how does that work, work out with, uh, storing your bike and showering and all that?|qw	B|Yeah,|b
B|what kind of biking do you do?|qw	A|Uh, well, actually my wife just got me into it|^h
A|So, uh, how long have you been biking?|qw	B|Oh, I guess as an adult for just about the past, uh, three years or so|sd
A|So, what school is it?|qw	B|Uh, University of Rochester.|sd
A|How about you?|qo	B|Uh, well, I don't actually live in the city,|h
A|How far out from the city, I mean, do you,|qw	B|I'm about fifteen miles out.|sd
B|Why is it happening?|qw	A|Well, most families, most families are young|sd
B|Well, what do you think can be done to reduce that sort of crime?|qw	A|Well, uh, the police force, for one,|sv
B|Well, what about an innocent person who happens to have been found guilty?|qw	A|Uh, I think they'd have to go to extra measures to make sure a person's guilty, you know, in a lot of cases.|sv
A|Well,  how do you get the edge though?|qw	B|How do you get the edge?|br
B|What color did you paint your house?|qw	A|White.|sd
B|what do you call those things?|qw	A|The blowers?|qy^d
B|How much  did it cost you for the paint for the outside?|qw	A|Shoot, maybe a hundred and fifty.|sd
B|So what do you think?|qo	A|Uh, the causes of crime?|br
B|Who's going to pay for mine?|qw	A|I don't know|no
B|Where you at?|qw	A|I'm in Raleigh, North Carolina.|sd
A|Well, where are you from?|qw	B|I'm in Dallas.|sd
B|Why was, you know, why|qw	A|Why did they do in the freezer?|^2
B|or, or what would you like to see?|qo	A|I would like, uh,|sv
A|what's your opinion on the, our policy down there?|qo	B|I don't think we have one.|sv
A|what was that book that you were saying to read, again?|qw	B|Tom, Clancy.|sd
A|Like in what sense?|qo	B|Well, um, in, uh, public schools I guess there there are a lot of, of, you know,|sv
B|Where did you go?|qw	A|what?|br
B|Where did you go?|qw	A|I went to University.|sd
A|Where's that?|qw	B|That's in Chappel Hill|sd
B|What kind of a car do you have now?|qw	A|Oh, we've got a, uh, an older Delta Eighty-Eight,|sd
B|What kind of cars do you, do you usually drive?|qw	A|Right now we, I've got a, uh, four year old Subaru and a two year old Honda.|sd
A|What do you think is your primary cause of it.|qw	B|Well, I think it's industry|sv
B|Well what can we do about the, the, the, the air conditioning problem?|qw	A|Well they're working now,|sd
B|How much does, uh, planting more trees and things like that help?|qo	A|Oh I think that's very important to do.|sv
A|What do you think about it?|qo	B|Uh, well, immigration,|sd
A|But anyway, what do you think we've gained from the spaceflights?|qo	B|Well uh, I'm not sure to be honest with you,|^h
A|Where do you live?|qw	B|Uh, we live in, uh, Utah.|sd
B|What are we supposed to discuss again?|qw	A|AIDS research is something that, that, I think whether our country is putting enough money into it|sv
B|but so what does that,|qw	A|Right.|b
A|And how is it really transmitted, et cetera.|qw	B|Yeah.|b
A|How?|qw	B|Don't answer your phone, Hello.|ad
B|So, how long did you play?|qw	A|Only for about three months.|sd
B|now what kind of music do you listen to?|qw	A|Well, I listen to like ninety-seven point one, you know, more,|sd
B|What what is that?|qw	A|It's more, uh,|%
B|Well, what kind of car would you buy?|qw	A|Well, it's kind of hard to say,|^h
B|What kind do you have now?|qw	A|Uh, we have a, a Mazda nine twenty nine and a Ford Crown Victoria and a little two seater C R X.|sd
A|So what do you think about caring for older folks Dale?|qo	B|Well, I think, uh the elderly is a really neat population to care for.|sv
B|What about you?|qo	A|Well, I'm thinking about it more in terms of my parents that are starting to get old.|sd
A|Um, so what do you think?|qo	B|Um,|^h
B|How long have you had it?|qw	A|We've had him for,|sd
B|How much does he weigh now?|qw	A|He, actually, he just went to the vet yesterday to get his shots and everything,|sd
A|How about you?|qo	B|Well, we have a cat who's also about four years old.|sd
B|what is that?|qw	A|It's, uh, it's a system you can put in your yard where you bury these little, uh, transducers or emitters in your yard at the perimeter|sd
A|What, uh, what kind of climate do you have?|qw	B|Well, uh, it's, we just moved recently|sd
A|What do you usually wear to,|qw	B|Well, let's see.|^h
A|Um. What kind of|qw	B|It's, uh,  It's, uh, it's, uh, plywood, uh, face, I guess.|sd
B|Uh, how about yourself?|qo	A|Well I'm, I am interested in woodworking.|sd
B|What, what type of art do you focus on?|qw	A|I have a Master's degree|sd
B|Huh.  So you have a M F A in, in what division of art?|qw	A|but,|%
